My neighborhood has a good sense of community.	Mi vecino tiene un buen sentido de comunidad.	
"He's written on many different topics."	Él ha escrito sobre diversos temas.	
"I sometimes forget people's birthdays."	A veces olvido los cumpleaños de la gente.	
The brightest thing in the sky is the sun.	La cosa más brillante en el cielo es el sol.	
"When are Arjun and Sasha coming? -- They've yet to come."	¿Cuándo vienen Arjun y Sasha? -- Todavía no vienen.	
You found my key two (2) weeks ago.	Encontraste mi llave hace dos semanas.	
I will need a piece of paper for the test.	Necesitaré una hoja de papel para la prueba.	
During my summer break, I travelled to Europe.	Durante mis vacaciones de verano, viajé a Europa.	
Can you send me a text about the details?	¿Me puede enviar un texto sobre los detalles?.	
What did you do to celebrate your birthday?	¿Qué hizo para celebrar su cumpleaños?	
"Do you think it's going to rain tomorrow?"	¿Crees que lloverá mañana?	
What did you eat during your trip to Iceland?	¿Qué comiste durante tu viaje a Islandia?	
Select the option that best fits you.	Seleccione la opción que mejor se adapte a usted.	
In my dreams, pigs could fly.	En mis sueños, los cerdos podían volar.	
The conversation lasted almost three hours.	La conversación duró casi tres horas.	
What is the best way to fly on a budget?	¿Cuál es la mejor manera de volar con un bajo presupuesto?	
I did not receive the package from Amazon yet.	Aún no recibí el paquete de Amazon.	
How easy is it to make a phone call to Mexico?	¿Qué tan fácil es hacer una llamada a México?	
Does she clean the plates by hand?	¿Ella limpia los platos a mano?	
We must be conservative with our estimates.	Debemos ser conservadores con nuestras estimaciones.	
She used Instagram to promote her new app.	Ella usó Instagram para promocionar su nueva aplicación.	
I do not believe the official reason for the war.	No creo en la razón oficial de la guerra.	
It is a miracle that we are still alive.	Es un milagro que todavía estemos vivos.	
What is the effect of sodium on your health?	¿Cuál es el efecto del sodio en su salud?	
Does he play sports? -- No, not anymore.	¿Él practica algún deporte? -- No, ya no lo hace.	
The patient went to the doctor for a cough.	El paciente fue al médico por toser.	
These two items are equal in value.	Estos dos elementos son iguales en valor.	
"Even though it's not great, it is acceptable."	Aunque no es genial, es aceptable.	
Have you registered online with the bank yet?	¿Te has registrado en línea con el banco?	
"We've been married for sixteen (16) years."	Nosotros hemos estado casados por dieciséis (16) años.	
The job was not interesting, but it paid well.	El trabajo no era interesante, pero pagó bien.	
You will find my name on the top of the page.	Usted encontrará mi nombre en la parte superior de la página.	
I jumped over the pile of trash.	Salté sobre la pila de basura.	
Life has changed for the better because of technology.	La vida ha cambiado para mejor debido a la tecnología.	
He likes to drive his car all the time.	A él le gusta manejar su coche todo el tiempo.	
My sister and I are good basketball players.	Mi hermana y yo somos buenos jugadores de basketball.	
I bought a new camera last Thursday.	Compré una cámara nueva el jueves pasado.	
"It's December. She's been there since May."	Ya es diciembre. Está ahí desde mayo.	
Have you got a camcorder? -- Yes, I do.	¿Conseguiste una cámara de video? -- Sí, la tengo.	
I ate dinner two (2) hours ago.	Cené hace dos (2) horas.	
"My father's only traveled by car."	Mi papá únicamente ha viajado en coche.	
"She wasn't used to feeling limitless."	No estaba acostumbrada a sentirse ilimitada.	
I heard the doorbell ring. Did you?	Yo escuché el timbre de la puerta sonar. ¿Lo escuchó?	
I feel weak because I am hungry.	Me siento débil porque tengo hambre.	
"He likes his job because it's fun."	A él le gusta su trabajo porque es divertido.	
I hope this feeling lasts forever.	Espero que este sentimiento dure para siempre.	
The artist painted a picture of the sunset.	El artista pintó una imagen del atardecer.	
The public library closes early today.	La biblioteca pública cierra temprano hoy.	
Do you want to buy the latest smartphone?	¿Quieres comprar el último smartphone?	
He works in the chemistry department at the university.	Él trabaja en el departamento de química en la universidad.	
Have they ever been to India? -- Yes, once.	¿Ellos han estado en La India? -- Sí, una vez.	
The small business employs forty people.	La pequeña empresa emplea a cuarenta personas.	
Have you read any good books lately?	¿Ha leído algún buen libro últimamente?	
"The product was responsible for the company's success."	El producto fue responsable del éxito de la empresa.	
Their summer vacation ends in August.	Sus vacaciones de verano finalizan en agosto.	
This mug has an interesting shape.	Esta taza tiene una forma interesante.	
Has she told her friend the bad news?	¿Ya le contó a su amiga las malas noticias?	
Playing board games is a social activity.	Jugar juegos de mesa es una actividad social.	
Does the president still have control over the war?	¿Tiene el presidente todavía control sobre la guerra?	
There are fourteen counties in this state.	Hay catorce condados en este estado.	
I knew that song before it was mainstream.	Yo conocía esa canción antes de que fuera popular.	
It happened when she was rock climbing.	Sucedió cuando escalaba las rocas.	
She held her breath for two minutes.	Ella contuvo la respiración durante dos minutos.	
I think we can treat each other better.	Creo que podemos tratarnos mejor el uno al otro.	
This bouquet has a variety of flowers.	Este ramo tiene una variedad de flores.	
The library closes at four (4:00) in the afternoon.	La biblioteca cierra a las cuatro (4:00) de la tarde.	
The sugar dissolved in the boiling water.	El azúcar se disolvió en el agua hirviendo.	
The mathematician made precise calculations.	El matemático hizo cálculos precisos.	
What time did you get up yesterday morning?	¿A qué hora te levantaste ayer en la mañana?	
I put the frozen dinner in the microwave.	Puse la cena congelada en el microondas.	
Plato was a philosopher and had many good ideas.	Platón era filósofo y tenía muy buenas ideas.	
The two events must be linked somehow.	Los dos eventos deben estar vinculados de alguna manera.	
This is the tallest living tree in the world.	Este es el árbol viviente más alto del mundo.	
Who knows what is at the bottom of the ocean?	¿Quién sabe qué hay en el fondo del océano?	
How would you behave in a difficult situation?	¿Cómo se comportaría usted en una situación difícil?	
How is your job? Do you find it interesting?	¿Cómo es tu trabajo? ¿Es interesante?	
"You weren't at work yesterday. What happened?"	No estabas en el trabajo ayer. ¿Qué pasó?	
What does a typical day look like for you?	¿Cómo es un día típico para usted?	
After a long war, the country wanted peace.	Después de una larga guerra, el país quería la paz.	
I wrestled with my bare hands.	Luché con mis manos descubiertas.	
I like to eat dried mangoes.	Me gusta comer mangos secos.	
"I'm wearing my new pair of shoes."	Estoy usando mis zapatos nuevos.	
The wet floor is a potential hazard.	El piso mojado es un peligro potencial.	
The jacket is practical but not stylish.	La chaqueta es práctica pero no elegante.	
"This is my grandmother's original recipe."	Esta es la receta original de mi abuela.	
I rubbed lotion on my face.	Me froté loción en mi cara.	
What is the most complex part of the human body?	¿Cuál es la parte más compleja del cuerpo humano?	
"We'll have two glasses of water please."	Dos vasos de agua por favor.	
Historical records are kept at the library.	Los registros históricos se guardan en la biblioteca.	
If you finish early, please wait for me.	Si termina temprano, por favor espéreme.	
My shirt got wet from the storm.	Mi camisa está mojada por la tormenta.	
There are a lot of facts in that textbook.	Hay muchos hechos en ese libro.	
The building used to be a bowling alley.	El edificio solía ser un boliche.	
When was the last time you talked to your mother?	¿Cuándo fue la última vez que hablaste con tu mamá?	
The most productive place to study is the library.	El lugar más productivo para estudiar es la biblioteca.	
They bought a new truck last month.	Ellos compraron un nuevo camión el mes pasado.	
This sewing machine is very efficient.	Esta máquina de coser es muy eficiente.	
Mike and Wendy got together eighteen (18) months ago.	Mike y Wendy están juntos desde hace dieciocho (18) meses.	
After running a marathon, she was tired.	Después de correr una maratón, ella estaba cansada.	
I like taking long walks by the beach.	Me encanta dar largos paseos por la playa.	
The rain does not affect my mood.	La lluvia no afecta mi estado de ánimo	
Have they ever been to Japan? -- No, not once.	¿Ellos han estado en Japón? -- No, ni una sola vez.	
I have some good news and some bad news.	Tengo algunas buenas noticias y algunas malas noticias.	
Our economy is doing better because of the president.	Nuestra economía está mejorando gracias al presidente.	
Climate change is an important issue to her.	El cambio climático es un asunto importante para ella.	
The usual solutions to the problem did not work.	Las soluciones usuales al problema no funcionaron.	
The magician made the dove disappear.	El mago hizo desaparecer a la paloma.	
The point of going to school is to get a good education.	El punto de ir a la escuela es obtener una buena educación.	
"How were you feeling at seven o'clock (7:00)?"	¿Cómo te sentías a las siete 7:00?	
My least favorite food is broccoli.	Mi comida menos favorita es el brócoli.	
Safety is important. Wear a seatbelt.	La seguridad es importante. Use el cinturón de seguridad.	
I carry my wallet everywhere I go.	Llevo mi billetera a donde vaya.	
The forest is full of evergreen trees.	El bosque está lleno de árboles de hoja perenne.	
"Eliot's been here since Monday."	Eliot ha estado aquí desde el lunes.	
The architect designed a new town hall.	El arquitecto diseñó un nuevo ayuntamiento.	
Everyone deserves access to language education.	Todos merecen acceso a la educación de idiomas.	
The boy rode his bicycle to the school.	El niño manejó su bicicleta hacia la escuela.	
These shoes are nice. How much are they?	Estos zapatos están bonitos. ¿Cuánto cuestan?	
"They're ten dollars."	Cuestan diez dólares.	
They danced until the sun came up.	Bailaron hasta que el sol salió.	
Learning a new language requires patience.	Aprender un nuevo idioma requiere paciencia.	
I will check my calendar and get back to you.	Revisaré mi calendario y te llamaré.	
"It wasn't snowing when he was outside."	No estaba nevando cuando él se encontraba afuera.	
I woke up with a severe headache.	Me desperté con un severo dolor de cabeza.	
The alleged thief was actually innocent.	El supuesto ladrón era en realidad inocente.	
We have to live with the consequences of our actions.	Tenemos que vivir con las consecuencias de nuestras acciones.	
Japan does a lot of trade with France.	Japón hace mucho comercio con Francia.	
The ground was slippery so I tripped.	El suelo estaba resbaladizo, así que me tropecé.	
As a banker, your income is very high.	Como banquero, su ingreso es muy alto.	
The politician defended our human rights.	El político defendió nuestros derechos humanos.	
I have a photo of my father in my pocket.	Tengo una foto de mi padre en mi bolsillo.	
The villain in the movie was truly evil.	El villano en la película era realmente malvado.	
The potential for disaster cannot be ignored.	El potencial para un desastre no puede ser ignorado.	
What is the impact of your donation to the charity?	¿Cuál es el impacto de su donación a la caridad?.	
Am I allowed to record a video of the event?	¿Puedo grabar un video del evento?	
Has Culdasa arrived yet? -- No, not quite yet.	¿Culdasa ya llegó? -- No, aún no.	
He fell asleep while meditating.	Él se quedó dormido mientras meditaba.	
Did you meet anyone interesting at the event?	¿Conoció a alguien interesante en el evento?.	
His grandfather manages a huge company.	Su abuelo maneja una gran compañía.	
My ankle is swollen and tender.	Mi tobillo está hinchado y sensible.	
The president does a lot of administrative tasks.	El presidente hace muchas tareas administrativas.	
Would you ask him to call me back please?	¿Le podrías decir que me lláme de vuelta por favor?	
Beware my dog. She is fierce.	Cuidado con mi perra. Ella es feroz.	
Do you own a camcorder? -- Yes, I do.	¿Tienes una videocámara? -- Sí, sí tengo.	
"I don't like to argue about religious issues."	No me gusta discutir sobre temas religiosos.	
I like to stay active by playing sports.	Me gusta mantenerme activo jugando deportes.	
"It wasn't snowing when I left work."	No estaba nevando cuando me fui del trabajo.	
"Did it snow on Thursday? -- No, it didn't."	¿Nevó el jueves? -- No, no nevó.	
I got my dog from the animal shelter.	Obtuve a mi perro del refugio de animales.	
What do you often drink with your lunch?	¿Qué tomas normalmente con tu almuerzo?	
I think those shoes are very good looking.	Creo que esos zapatos se ven muy bien.	
How long has she been in China?	¿Cuánto tiempo lleva ella en China?	
"She's been in China for four (4) days."	Ella ha estado en China por cuatro (4) días.	
Is John working today?	¿John trabaja hoy?	
"No he isn't. But he will be tomorrow."	No, hoy no. Pero va a trabajar mañana.	
How old are you?	¿Cuántos años tienes?	
"I'm thirty nine (39) years old."	Tengo treinta y nueve (39) años.	
Having a family is an important part of life.	Tener una familia es una parte importante de la vida.	
"Don't forget to lock the front door."	No se olvide de cerrar la puerta de en frente con llave.	
The soccer team won the world championship.	El equipo de fútbol ganó el campeonato mundial.	
We live in a society that values education.	Vivimos en una sociedad que valora la educación.	
I carry my camera everywhere I go.	Llevo mi cámara a todos lados a donde vaya.	
The floor is slippery, so be careful.	El piso está resbaladizo, así que ten cuidado.	
Did you confirm your email address?	¿Confirmó su dirección de correo electrónico?	
The police officer is armed with a gun.	El oficial de policía está armado con una pistola.	
Why did she steal my pen?	¿Por qué ella robó mi pluma?	
I see four dogs playing in the park.	Veo cuatro perros jugando en el parque.	
Turn right when you reach the intersection.	Gire a la derecha cuando llegue a la intersección.	
Practice is crucial to winning a race.	La práctica es crucial para ganar una carrera.	
You sound like a native speaker to me.	Usted me suena como un hablante nativo.	
What can be found at the bottom of the ocean?	¿Qué se puede encontrar en el fondo del océano?.	
When are you going to pick up your friend?	¿Cuándo vas a ir a recoger a tu amigo?	
"Are you hungry? -- No, but I'm thirsty."	¿Tienes hambre? -- No, tengo sed.	
"He's gotten to know many different people."	Él ha podido conocer a diferentes personas.	
I squeezed the tube of toothpaste.	Yo exprimí la pasta de dientes.	
Jimmy lives in Bali. How long has he lived in Bali?	Jimmy vive en Bali. ¿Cuánto tiempo ha vivido en Bali?	
The silk scarf is so smooth.	La bufanda de seda es muy suave.	
Alex visited his grandmother last Christmas.	Alex visitó a su abuela la navidad pasada.	
I always listen to the radio on the way to work.	Siempre escucho la radio en el camino al trabajo.	
It takes a long time to become a doctor.	Lleva un tiempo largo convertirse en doctor.	
I am too busy to have hobbies.	Estoy demasiado ocupado para tener pasatiempos.	
My schedule last week was overwhelming.	Mi agenda de la semana pasada fue abrumadora.	
That school has an excellent business program.	Esa escuela tiene un excelente programa de negocios.	
What is the risk of not wearing a helmet?	¿Cuál es el riesgo de no usar un casco?	
What is a classic dish in your country?	¿Cuál es un plato clásico en su país?	
The figure in the textbook was very helpful.	La figura en el libro de texto fue muy útil.	
Da Vinci drew a diagram of the human body.	Da Vinci dibujó un diagrama del cuerpo humano.	
In the year two thousand (2000), we were watching The Matrix.	En el año dos mil (2000) estábamos viendo Matrix.	
Mary went to the beach last weekend.	Mary fue a la playa el fin de semana pasado.	
What makes the cake taste so great?	¿Qué hace que el pastel tenga un sabor tan estupendo?	
Are you going to take a plane or train?	¿Vas a tomar un avión o el tren?	
I usually drink coffee at breakfast.	Generalmente bebo café en el desayuno.	
What does he often do on Saturdays?	¿Qué hace él normalmente los sábados?	
I always drink tea at noon (12:00).	Siempre tomo té a mediodía (12:00).	
The general commanded his army to victory.	El general dirigió a su ejército a la victoria.	
My mother cares about me very much.	Mi madre se preocupa mucho por mí.	
My backpack is light when I travel.	Mi mochila está liviana cuando viajo.	
"His father's at home. He's at school."	Su papá está en su casa. Él está en la escuela.	
He challenged me to a chess match.	Él me desafió a una partida de ajedrez.	
What is the maximum volume on this device?	¿Cuál es el volumen máximo en este dispositivo?	
I am dependent on coffee in the morning.	Yo soy dependiente del café en la mañana.	
"I don't watch videos very regularly."	No veo videos muy seguido.	
What is the chance that it rains tomorrow?	¿Cuál es la probabilidad de que llueva mañana?	
"What is the president's new tax policy?"	¿Cuál es la nueva política fiscal del presidente?	
You must wear professional attire.	Usted debe vestir ropa profesional.	
"Are Owen and Trina there? -- No, they aren't here yet."	¿Owen y Trina están ahí? -- No, aún no están aquí.	
He is sensitive to hurtful comments.	Él es sensible a los comentarios hirientes.	
My grandmother is an elderly woman.	Mi abuela es una mujer mayor.	
I studied for the history test and passed.	Estudié para la prueba de historia y pasé.	
I cannot tell you because it is a secret.	No puedo decírselo porque es un secreto.	
I shook the rug to clean it.	Sacudí la alfombra para limpiarla.	
Ancient history is a fascinating subject.	La historia antigua es un tema fascinante.	
Roger Federer served the ball on the tennis court.	Roger Federer sirvió la pelota en la cancha de tennis.	
Did you just tap on my shoulder?	¿Acabas de tocarme el hombro?	
Can I invite my friend to your party?	¿Puedo invitar a mi amigo a su fiesta?	
Mike and Wendy have been together for eighteen (18) months.	Mike y Wendy han estado juntos desde hace dieciocho (18) meses.	
I wore my new shoes yesterday.	Usé mis zapatos nuevos ayer.	
Because of the president, we are in a difficult situation.	Debido al presidente, estamos en una situación difícil.	
Her scientific achievements were impressive.	Sus logros científicos fueron impresionantes.	
"She doesn't play the guitar very well."	Ella no toca muy bien la guitarra.	
Did you warn me about the snakes?	¿Usted me advirtió sobre las serpientes?	
The business deal was fair to all parties.	El trato comercial fue justo para todas las partes.	
How much does it cost per day?	¿Cuánto cuesta por día?	
There are sixty seconds in a minute.	Hay sesenta segundos en un minuto.	
She thinks rabbits are cute.	Ella piensa que los conejos son lindos.	
I stood in the line for over an hour.	Estuve en la fila por más de una hora.	
"He's visited over twenty (20) countries."	Él ha visitado más de veinte (20) países.	
What is the difference between intelligence and knowledge?	¿Cuál es la diferencia entre inteligencia y conocimiento?.	
How do you spend time on Sundays?	¿Qué haces los Domingos?	
"I've started working at my new job."	He empezado a trabajar en mi nuevo empleo.	
The amusement park is fun for children.	El parque de diversiones es divertido para los niños.	
I filled my tank with gasoline.	Llené mi tanque con gasolina.	
My grandmother collects stamps.	Mi abuela colecciona estampillas.	
"He's won a competition a few times."	Él ha ganado una competencia varias veces.	
During the battle, many people were injured.	Durante la batalla, muchas personas resultaron heridas.	
Go outside and get some fresh air.	Vaya afuera y tome aire fresco.	
"What were you reading at three o'clock (3:00)?"	¿Qué estabas leyendo a las tres (3:00)?	
She dipped the cookies in milk.	Ella mojó las galletas en leche.	
Did he run outside yesterday morning?	¿Él salió a correr ayer en la mañana?	
The water was clear and free of pollutants.	El agua estaba clara y libre de contaminantes.	
The heat is sometimes too much to bear.	El calor a veces es demasiado para soportar.	
Where did he buy his skateboard?	¿Dónde compró su patineta?	
I think that she cheated on the exam.	Yo pienso que ella hizo trampa en el examen.	
"Where's Noah? -- He's out taking photos."	¿Dónde esta Noah? -- Está fuera tomando fotos.	
She wore an elegant dress.	Ella usaba un elegante vestido.	
I pointed my finger towards the man.	Apunté mi dedo hacia el hombre.	
Do you know where I can get a taxi?	¿Sabes dónde puedo tomar un taxi?	
He lifted weights at the gym.	Él levantó pesas en el gimnasio.	
I heated my dinner in the microwave.	Calenté mi cena en el microondas.	
The incident happened last Saturday morning.	El incidente sucedió el sábado pasado en la mañana.	
The damage from the car accident was significant.	El daño del accidente automovilístico fue significativo.	
My vacation exceeded my expectations.	Mis vacaciones excedieron mis expectativas.	
How does health insurance benefit me?	¿Cómo me beneficia el seguro de salud?	
Harry was riding in a self-driving car.	Harry viajaba en un vehículo autónomo.	
How often do you consume alcohol?	¿Con qué frecuencia consume alcohol?	
How would you analyze the stock market?	¿Cómo analizaría el mercado de valores?	
These sounds are familar to me.	Estos sonidos me son familiares.	
Seating is limited so come early.	Los asientos son limitados, así que venga temprano.	
That family goes to church every Sunday.	Esa familia va a la iglesia todos los domingos.	
The only person he respects is his father.	La única persona a quien él respeta es a su padre.	
Thomas developed his own scientific theory.	Thomas desarrolló su propia teoría científica.	
I want to go to China next July.	Quiero ir a China el próximo julio.	
Nobody answered my phone call.	Nadie respondió a mi llamada telefónica.	
My house in the suburbs is very big.	Mi casa en los suburbios es muy grande.	
"Don't burn yourself on the stove."	No se queme en la estufa.	
We had lunch two hours ago.	Almorzamos desde hace dos horas.	
Please give me a reminder tomorrow.	Por favor deme un recordatorio mañana.	
He decided not to shave in November.	Decidió no afeitarse en noviembre.	
What is the estimated attendance for the event?	¿Cuál es la asistencia estimada para el evento?	
The Dark Ages were a terrible period for humanity.	La Edad Media fue un período terrible para la humanidad.	
The boy raised his hand at school.	El chico levantó su mano en clase.	
What motorcycle brand does he have?	¿Qué marca es su motocicleta?	
What time do you go to work everyday?	¿A qué hora vas al trabajo todos los días?	
"Mark's been in Cambodia for four (4) months."	Mark ha estado en Camboya por cuatro (4) meses.	
Education is a good investment for many people.	La educación es una buena inversión para muchas personas.	
What is that sound coming from the bathroom?	¿Qué es ese sonido que viene del baño?.	
Your children are very well behaved.	Tus hijos se portan muy bien.	
Can you smell the roses in the park?	¿Puede oler las rosas en el parque?	
I snapped my fingers to the beat.	Chasqueé mis dedos al ritmo.	
What is the minimum payment that is due?	¿Cuál es el pago mínimo que se debe?	
Would you like to consult an expert?	¿Le gustaría consultar a un experto?	
"Sometimes she's late, but not usually."	A veces ella llega tarde, pero normalmente no.	
"They've been to Argentina, but they haven't been to Chile."	Ellos han estado en Argentina, pero nunca han estado en Chile.	
She hopes that she will get the job.	Ella espera conseguir el trabajo.	
Showing up is the first step to success.	Hacerse presente es el primer paso para el éxito.	
"I'd like a table near the window."	Me gustaría una mesa cerca de la ventana.	
"I'd like a non-smoking room."	Quisiera un cuarto de no fumar.	
The two dogs in the picture look similar.	Los dos perros en la imagen se ven similares.	
Can you name thirty different countries?	¿Puedes nombrar treinta países diferentes?	
There are a lot of pages in this book.	Hay muchas páginas en este libro.	
Are you wearing two different socks?	¿Está usando dos calcetines diferentes?	
I flipped the eggs on the pan.	Volteé los huevos en la sartén.	
Literature is an important part of culture.	La literatura es una parte importante de la cultura.	
Push the button and see what happens.	Presione el botón y vea qué pasa.	
Orientation is at the beginning of the school year.	La orientación es al comienzo del año escolar.	
"The surgeon's hands are steady."	Las manos del cirujano son estables.	
Where are you hiding? I can hear you.	¿Dónde se esconde? Puedo oírlo.	
This university has some intelligent students.	Esta universidad tiene algunos estudiantes inteligentes.	
What time do you wake up in the morning?	¿A qué hora se levanta por la mañana?	
I confronted my fear for the first time.	Yo enfrenté mi miedo por primera vez.	
What is your overall impression of the book?	¿Cuál es su impresión general del libro?	
That person over there is my best friend.	Esa persona ahí es mi mejor amigo.	
Did you go to the business meeting yesterday?	¿Usted fue a la reunión de negocios ayer?.	
"Do you think it'll rain today?"	¿Crees que lloverá hoy?	
Does he really have a billion dollars?	¿Él realmente tiene un billón de dólares?	
"I'm thirsty. Can I have some water?"	Tengo sed. ¿Me das agua?	
Have they ever visited the Bahamas? -- Yes, once.	¿Ellos han visitado las Bahamas? -- Sí, una vez.	
I want to live close to a big city.	Quiero vivir cerca de una gran ciudad.	
"I didn't watch videos last night."	No vi videos anoche.	
My boss was pleased with my work.	Mi jefe estuvo satisfecho con mi trabajo.	
How many hours a week do you work?	¿Cuántas horas a la semana trabajas?	
With great power comes great responsibility.	Con un gran poder viene una gran responsabilidad.	
Take it easy, we have plenty of time.	Tranquilo, tenemos mucho tiempo.	
There are only two schools in this town.	Solo hay dos escuelas en esta ciudad.	
How do you construct a skyscraper?	¿Cómo se construye un rascacielos?	
The sign says that this is a dead end.	El letrero dice que esto es un callejón sin salida.	
Are you fine with moving to a new city?	¿Está bien con mudarse a una nueva ciudad?	
She failed her driving exam.	Ella falló su examen de manejo.	
"Sorry, we don't have any vacancies."	Lo siento, no tenemos vacantes.	
The president has a great relationship with congress.	El presidente tiene una gran relación con el Congreso.	
After the negotiations, the prisoners were released.	Después de las negociaciones, los prisioneros fueron liberados.	
Yudong is in the shower.	Yudong se está bañando.	
How long has she known Ashley?	¿Desde hace cuánto conoce a Ashley?	
Can we discuss your travel plans?	¿Podemos discutir sus planes de viaje?	
What time are you going to the bus station?	¿A qué hora vas a la estación de autobuses?	
She is a talented software engineer.	Ella es una talentosa ingeniera de software.	
I see twenty clouds in the sky.	Veo veinte nubes en el cielo.	
This shirt belongs in that pile.	Esta camisa pertenece a esa pila.	
What is your analysis of the presidential election?	¿Cuál es su análisis de las elecciones presidenciales?	
"It's your turn to wash the dishes."	Es tu turno de lavar los platos.	
Ice cream tastes sweet.	El helado sabe dulce.	
What do you usually eat for dinner?	¿Qué sueles comer para la cena?.	
There are some apples in the refrigerator.	Hay algunas manzanas en el refrigerador.	
I have been a member of that association for years.	He sido miembro de esa asociación por años.	
Can I borrow a sheet of paper?	¿Puedo tomar prestada una hoja de papel?	
Please state your name after the tone.	Por favor, indique su nombre después del tono.	
I swear that I will never lie to you.	Yo juro que nunca le mentiré.	
Where is your favorite place to ski?	¿Dónde está tu lugar favorito para esquiar?	
A river flows between the two states.	Un río fluye entre los dos estados.	
"She isn't at work. She's at home."	Ella no está en el trabajo. Está en su casa.	
"She wasn't taking a lunch break."	Ella no estaba tomando su descanso para almorzar.	
The university has excellent security at night.	La universidad tiene excelente seguridad por la noche.	
He begged her for a second chance.	Él le suplicó a ella por una segunda oportunidad.	
I always tip the taxi driver.	Siempre le doy propina al taxista.	
He praised him for his hard work.	Él lo elogió por su arduo trabajo.	
What subject does Mike teach at school?	¿Qué tema enseña Mike en la escuela?	
"They've stayed in Lisbon for five (5) months."	Ellos se han quedado en Lisboa por cinco (5) meses.	
The noise is too loud to ignore.	El ruido es demasiado alto para ignorarlo.	
What is the most direct flight to Paris?	¿Cuál es el vuelo más directo a París?	
"Zack's browsing the internet."	Zack está navegando en internet.	
Intelligence is not as important as imagination.	La inteligencia no es tan importante como la imaginación.	
Thank you for correcting my mistakes.	Gracias por corregir mis errores.	
Please be quiet. I need to concentrate.	Por favor haz silencio. Necesito concentrarme.	
It snowed when we were at work.	Nevó cuando estábamos en el trabajo.	
Taylor sings at the church every weekend.	Taylor canta en la iglesia todos los fines de semana.	
There are a lot of rocks on the mountain.	Hay muchas rocas en la montaña.	
I sliced the apple with a knife.	Corté la manzana con un cuchillo.	
I have an interesting perspective on politics.	Tengo una perspectiva interesante sobre la política.	
I am positive that he is lying to me.	Soy positivo de que él me está mintiendo.	
I only rarely like to go to bars.	Muy raras veces me gusta ir a bares.	
Who is your favorite professor at the university?	¿Quién es su profesor favorito en la universidad?.	
Have you ever been to the southern hemisphere?	¿Alguna vez ha estado en el hemisferio sur?	
How frequently do you take showers?	¿Qué tan seguido te bañas?	
Hydrogen and oxygen combine to form water.	El hidrógeno y el oxígeno se combinan para formar agua.	
How is Bob adjusting to suburban life?	¿Cómo se está adaptando Bob a la vida suburbana?	
Be sure to cite the original source.	Asegúrese de citar la fuente original.	
Do you want me to come and pick you up?	¿Quieres que vaya a recogerte?	
"I'm very busy. I don't have time now."	Estoy muy ocupado. No tengo tiempo ahora.	
"What time do you think you'll arrive?"	¿A que hora crees que llegarás?	
You look fit. Have you been working out?	Usted se ve en forma. ¿Ha estado ejercitándose?	
The sunburn felt very painful.	La quemadura de sol se sintió muy dolorosa.	
What is the easiest class at this university?	¿Cuál es la clase más fácil en esta universidad?	
Lawyers need to understand the legal system.	Los abogados necesitan entender el sistema legal.	
The oil industry makes a lot of money.	La industria petrolera hace mucho dinero.	
"Jack isn't available; he's off to lunch."	Jack no está disponible; salió a almorzar.	
When I was a baby, I cried a lot.	Cuando yo era un bebé, lloré mucho.	
He used to live in the same town as me.	Él solía vivir en el mismo pueblo que yo.	
He downloaded it from the app store.	Él la descargó de la app store.	
Turn right at the next traffic light.	Gire a la derecha en el siguiente semáforo.	
The mathematical equations were sophisticated.	Las ecuaciones matemáticas fueron sofisticadas.	
"Were Ann and Jeff at the beach? -- Ann was there, but Jeff wasn't."	¿Ann y Jeff estaban en la playa? -- Ann sí estaba ahí, pero Jeff no.	
"Where's your mother? Is she at home?"	¿Donde está tu mamá? ¿Está en casa?	
My father has a lot of power in the government.	Mi padre tiene mucho poder en el gobierno.	
Zack runs around the track.	Zack corre por la pista.	
He landed safely at the airport.	Él aterrizó con bien en el aeropuerto.	
She has several cats and dogs.	Ella tiene varios gatos y perros.	
The couple decided to adopt a child.	La pareja decidió adoptar un niño.	
Knock on the door before you come in.	Golpee la puerta antes de entrar.	
I played golf Tuesday morning.	Jugué golf el martes por la mañana.	
My laptop is thick and heavy.	Mi laptop es gruesa y pesada.	
I often walk to work, but not always.	Frecuentemente camino al trabajo, pero no siempre.	
How many people do you have in your family?	¿Cuántas personas son en tu familia?	
I think the rules of the game are unfair.	Creo que las reglas del juego son injustas.	
The library is a quiet place to study.	La biblioteca es un lugar tranquilo para estudiar.	
Her future as a doctor is bright.	Su futuro como médico es brillante.	
I only have two pairs of shoes.	Solo tengo dos pares de zapatos.	
How did you know the lyrics to the song?	¿Cómo supo la letra de la canción?	
"Are you ready to leave? It's time to go."	¿Estás listo para irte? Es hora de irnos.	
What is the importance of showing up on time?	¿Cuál es la importancia de llegar a tiempo?.	
She used to swim competitively.	Ella solía nadar competitivamente.	
There are a lot of holidays in December.	Hay muchas vacaciones en diciembre.	
The school district has excellent schools.	El distrito escolar tiene excelentes escuelas.	
"I'm not listening to the radio right now."	No estoy escuchando el radio en este momento.	
Skydiving was an amazing experience.	El paracaidismo fue una experiencia increíble.	
Come a little bit early to the meeting.	Venga un poco temprano a la reunión.	
We heard about it from a coworker.	Escuchamos sobre Bután por un compañero de trabajo.	
Every April, my family travels to France.	Cada abril mi familia viaja a Francia.	
The other restaurant was better in my opinion.	En mi opinión, el otro restaurante fue mejor.	
Wait for me if you arrive early.	Espéreme si llega temprano.	
Gold is a very valuable resource.	El oro es un recurso muy valioso.	
Where do you buy organic food?	¿Dónde compra comida orgánica?	
I would like to explore Paris during the summer.	Me gustaría explorar París durante el verano.	
She works as a mechanical engineer.	Ella trabaja como ingeniera mecánica.	
I would like to introduce you to my friend Sally.	Me gustaría presentarle a mi amiga Sally.	
Can you describe what you see in the picture?	¿Puede describir lo que ve en la imagen?	
Please guide me to the train station.	Por favor, guíeme a la estación de tren.	
"You've always ridden horses."	Tú siempre has montado a caballo.	
Can you evaluate my current situation?	¿Puede evaluar mi situación actual?	
Does her friend stay around here?	¿Su amiga se está quedando por aquí?	
The weather seems very cold today.	El clima parece muy frío hoy.	
The man is wearing two right shoes.	El hombre tiene puestos dos zapatos derechos.	
There are numerous fish in the sea.	Hay numerosos peces en el mar.	
Facebook is a large social network.	Facebook es una gran red social.	
It snows a lot in the winter.	Nieva mucho en invierno.	
What did you pick for dessert?	¿Qué eligió de postre?	
"I'd like some water too, please."	Quiero un poco de agua también por favor.	
"They're planning to come next year."	Ellos planean venir el próximo año.	
My motorcycle has two (2) wheels.	Mi motocicleta tiene dos (2) ruedas.	
"He's been in Canada for two (2) days."	Él ha estado en Canadá por dos (2) días.	
Your cell phone is ringing.	Tu celular está sonando.	
We painted our house yellow.	Pintamos nuestra casa amarilla.	
Did you have a good time?	¿Pasaste un buen rato?	
We had a bad time. It was awful.	La pasamos mal. Fue espantoso.	
Are you sitting on the couch?	¿Estás sentado en el sillón?	
Yes, I am sitting on the sofa.	Sí, estoy sentado en el sillón.	
What time did she arrive?	¿A qué hora llegó ella?	
She arrived at ten-thirty (10:30).	Ella llegó a las diez treinta (10:30).	
"I sense that you're feeling sad."	Siento que usted se siente triste.	
It rained very hard today.	Llovió muy fuerte el día de hoy.	
Most vehicles have five (5) seats.	La mayoría de los vehículos tienen cinco (5) asientos.	
My tank is full of gasoline.	Mi tanque está lleno de gasolina.	
When does your mother wake up?	¿A qué hora despierta tu mamá?	
It is cool outside, but not cold.	Está fresco afuera, pero no frío.	
My mother works as an attorney.	Mi madre trabaja como abogada.	
Is the movie based on a true story?	¿Está la película basada en una historia verdadera?	
"I'd like the number for the hotel please."	Quisiera el número del hotel, por favor.	
If you break it, you must buy it.	Si lo rompe, debe comprarlo.	
I am grateful for the work that you do.	Estoy agradecido por el trabajo que usted hace.	
Is your dog male or female?	¿Tu perro es macho o hembra?	
My bowl is full of cereal.	Mi taza está llena de cereal.	
He does not have to go to work today.	Él no tiene que ir hoy al trabajo.	
The barrier was purely psychological.	La barrera era puramente psicológica.	
The quick rabbit ran away.	El rápido conejo se escapó.	
"They don't know my email address."	Ellos no saben mi dirección de email.	
I crossed the street at the intersection.	Crucé la calle en la intersección.	
How often do you watch videos?	¿Qué tan seguido ves videos?	
Amanda and Peter chatted for half an hour.	Amanda y Peter platicaron por media hora.	
Can you promise me that you will be there?	¿Puede prometerme que estará allí?	
He likes her new blouse.	A él le gusta su blusa nueva.	
I came to the park to enjoy nature.	Vine al parque para disfrutar de la naturaleza.	
"Mark Twain's writing was remembered for centuries."	El escrito de Mark Twain fue recordado por siglos.	
Forget the past and focus on the present.	Olvida el pasado y enfócate en el presente.	
The police finally captured the suspect.	La policía finalmente capturó al sospechoso.	
What would it take to save his life?	¿Qué se necesitaría para salvar su vida?	
How did your father get that job?	¿Cómo obtuvo su padre ese trabajo?	
What is the science behind your diet?	¿Cuál es la ciencia detrás de su dieta?	
"Where is she? -- She's at the supermarket."	¿Dónde está ella? -- Está en el supermercado.	
I never go to the cinema by myself.	Nunca voy al cine solo.	
What do you do in your spare time?	¿Qué haces en tu tiempo libre?	
Your apartment has a large kitchen.	Tu apartamento tiene una gran cocina.	
Make a left turn at the intersection.	Gire a la izquierda en la intersección.	
This time four (4) years ago I was in Rio de Janeiro.	A esta hora hace cuatro (4) años, yo estaba en Río de Janeiro.	
Are you going to attend their wedding?	¿Vas a asistir a la boda?	
Do not threaten me ever again.	No me vuelva a amenazar nunca más.	
Did you rest easy last night?	¿Pudiste descansar bien anoche?	
Yes, I rested easily.	Si, me fue fácil descansar.	
There are a million dollars in the budget.	Hay un millon de dólares en el presupuesto.	
Was she at the celebration? -- Yes, she was.	¿Ella estaba en la celebración? -- Sí, sí estaba.	
"They're building a museum downtown."	Están construyendo un museo en el centro.	
The plane has a slight delay.	El avión tiene un ligero retraso.	
"He's been divorced three (3) times."	Él se ha divorciado tres (3) veces.	
The jacket is decent, but not great.	La chaqueta es decente, pero no excelente.	
May I have another glass of wine?	¿Puedo tomar otra copa de vino?.	
"You're old. -- No, I'm not! I'm young."	Eres viejo. -- ¡Claro que no! Soy joven.	
My father was born on a Wednesday.	Mi padre nació un miércoles.	
What is the best strategy for chess?	¿Cuál es la mejor estrategia en el ajedrez?.	
What is the most important subject to learn?	¿Cuál es la materia más importante para aprender?	
What is your most valuable possession?	¿Cuál es su posesión más valiosa?	
The movie features famous actors.	La película es protagonizada por actores famosos.	
This is a renowned academic center.	Este es un centro académico de renombre.	
I do not respond well to threats.	No respondo bien a las amenazas.	
Please forgive me for being late.	Por favor, perdóneme por llegar tarde.	
"It isn't a matter of life or death."	No es asunto de vida o muerte.	
Tom looked unusually serious today.	Tom se veía inusualmente serio hoy.	
The night sky was pitch black.	El cielo nocturno estaba completamente negro.	
Tell him that I need to talk to him.	Dile que tengo que hablar con él.	
The show starts at nine tonight.	El show inicia hoy en la noche a las nueve.	
Solar energy is good for the environment.	La energía solar es buena para el medio ambiente.	
She was drinking butter coffee.	Ella estaba bebiendo café con mantequilla.	
You can disagree with me if you want.	Usted puede discrepar conmigo si quiere.	
The restaurant serves amazing Mexican food.	El restaurante sirve increíble comida mexicana.	
Can you pretend that I am not here?	¿Usted puede fingir que no estoy aquí?	
My children are doing their homework.	Mis hijos están haciendo su tarea.	
Are you available to meet at noon (12:00)?	¿Nos podemos ver a mediodía (12:00)?	
"Where are your children? -- They're at school."	¿Dónde están tus hijos? -- Están en la escuela.	
"I'll have a cup of tea please."	Quiero una taza de té por favor.	
I put my glass in the dishwasher.	Puse mi vaso en el lavaplatos.	
Matt Damon had an important role in that movie.	Matt Damon tuvo un papel importante en esa película.	
The play lasted over three hours.	La obra duró más de tres horas.	
What is your approach to language learning?	¿Cuál es su enfoque para el aprendizaje de idiomas?.	
"I don't watch movies very often."	No veo películas muy frecuentemente.	
Why did you leave the door open?	¿Por qué dejó la puerta abierta?	
Am I pronouncing it correctly?	¿Lo estoy pronunciando correctamente?	
Does he regularly eat in the morning?	¿Él come regularmente en la mañana?	
How much does a car weigh?	¿Cuánto pesa un automóvil?	
How long has it been snowing?	¿Cuánto tiempo ha estado nevando?	
Does the store sell groceries?	¿La tienda vende comestibles?.	
Is there a movie theater nearby?	¿Hay algun cine cerca de aquí?	
"He's never driven a tractor."	Él nunca ha manejado un tractor.	
What color are your new socks?	¿De qué color son tus calcetines nuevos?	
They are brown.	Son cafés.	
"I don't like her, and she doesn't like me."	Ella no me agrada, y yo no le agrado a ella.	
Are you available for coffee this weekend?	¿Quieres ir por un café este fin de semana?	
The trumpet is a musical instrument.	La trompeta es un instrumento musical.	
Where does your daughter go to school?	¿A qué escuela va tu hija?.	
The star of the play is in the middle of the stage.	La estrella de la obra está en el medio del escenario.	
The post office is that building over there.	La oficina de correos es ese edificio allí.	
Wikipedia is a comprehensive resource.	Wikipedia es un recurso extenso.	
But Zack likes to run around the track.	Pero a Zack le gusta correr por la pista.	
She is the most interesting person in the room.	Ella es la persona más interesante en la sala.	
They went to the historic part of town.	Ellos fueron a la parte histórica de la ciudad.	
The world is full of language learners.	El mundo está lleno de aprendices de idiomas.	
What is your most precious possession?	¿Cuál es tu posesión más preciosa?	
I lost my laptop at the library.	Perdí mi laptop en la biblioteca.	
She was asleep in bed, sick.	Ella estaba dormida en su cama, enferma.	
She is no longer afraid of death.	Ella ya no le teme a la muerte.	
Do you ride bicycles? -- Sometimes.	¿Usas la bicicleta? -- A veces.	
"Take a jacket. It's snowing."	Llévate una chaqueta. Está nevando	
"He doesn't like thriller films."	A él no le gustan las películas de suspenso.	
Only go to the hospital if it is necessary.	Vaya al hospital solo si es necesario.	
You can eat half of my cake.	Puede comer la mitad de mi torta.	
My library book is due today.	Mi libro de la biblioteca debe entregarse hoy.	
The team of doctors saved his life.	El equipo de doctores salvó su vida.	
It is illegal to be naked in public.	Es ilegal estar desnudo en público.	
Can you toss me my jacket?	¿Puede tirarme mi chaqueta?	
I thought of a great idea last night.	Anoche pensé en una gran idea.	
Does the lake freeze in the winter?	¿El lago se congela en el invierno?	
The babies were switched accidentally.	Los bebés fueron cambiados accidentalmente.	
Can we have some more bread please?	¿Podría traernos más pan por favor?	
Have you visited Brazil in the past three (3) years?	¿Has ido a Brasil en los últimos tres (3) años?	
"He's lived there his whole life."	Él ha vivido ahí toda su vida.	
Are you doing anything on Friday night?	¿Vas a hacer algo el viernes por la noche?	
What is living in Eastern Europe like?	¿Cómo es vivir en Europa Oriental?	
The sky looks cloudy today.	El cielo se ve nublado hoy.	
"Yesterday, she didn't go to the gym."	Ayer, ella no fue al gimnasio.	
The best kind of cake is chocolate.	El mejor tipo de pastel es el de chocolate.	
My home is not too far from work.	Mi hogar no está muy lejos del trabajo.	
"Samantha left the office at six o'clock (6:00)."	Samantha se fue de la oficina a las seis (6:00).	
My brother is stronger than I am.	Mi hermano es más fuerte que yo.	