Has she told her mother about the incident yet?	¿Ya le contó a su mamá sobre el incidente?	
"We fell asleep before nine o'clock (9:00)."	Nos dormimos antes de las nueve (9:00).	
I have no sense of direction, but fortunately I have Google Maps.	No tengo sentido de la dirección, pero afortunadamente tengo Google Maps.	
I do not need any help writing this essay.	Yo no necesito ayuda para escribir este ensayo.	
I sprayed the weeds with herbicide.	Rocié las malas hierbas con herbicida.	
"You've lost the key three (3) times this week."	Has perdido la llave tres (3) veces esta semana.	
Did you get the file that I attached to the email?	¿Recibió el archivo que adjunté al correo electrónico?	
It takes many years to build a skyscraper.	Lleva muchos años construir un rascacielos.	
Life is short, so you should do what you enjoy.	La vida es corta, así que debes hacer lo que disfrutas.	
He earns a lot of money at his job.	Él gana mucho dinero en su trabajo.	
For a brief moment, I thought I was dreaming.	Por un breve momento, pensé que estaba soñando.	
I use Google when I need to look something up.	Yo uso Google cuando necesito buscar algo.	
Do not worry about the test. It is very easy.	No se preocupe por la prueba. Es muy fácil.	
I try to read five books every month.	Intento leer cinco libros cada mes.	
Do you think this suit is appropriate for the meeting?	¿Cree que este traje sea apropiado para la reunión?	
"My cell phone doesn't have good reception."	Mi celular no tiene buena recepción.	
Does the tea taste a little bitter to you?	¿El té le sabe un poco amargo?	
They gathered sticks to make a bonfire.	Ellos recogieron palos para hacer una hoguera.	
This poem has exactly ninety words.	Este poema tiene exactamente noventa palabras.	
My foot hurts from kicking the wall.	Me duele el pie por patear la pared.	
I know how to count to ten in every language.	Sé cómo contar hasta diez en cada idioma.	
We danced, drank, and made new friends.	Bailamos, bebimos e hicimos nuevos amigos.	
I have many pleasant memories of my childhood.	Tengo muchos recuerdos agradables de mi infancia.	
He swam three laps in the pool.	Él nadó tres vueltas en la piscina.	
You need to be very lucky to win the lottery.	Usted tiene que ser muy afortunado para ganar la lotería.	
Are you willing to do what it takes to succeed?	¿Está dispuesto a hacer lo que sea necesario para tener éxito?	
When I stepped on the balloon, it popped.	Cuando pisé el globo, explotó.	
We started a relationship together three years ago.	Comenzamos una relación juntos hace tres años.	
"My motorcycle doesn't use a lot of fuel."	Mi motocicleta no gasta mucha gasolina.	
I highlighted all of the words that I did not understand.	Yo subrayé todas las palabras que no entendí.	
She is vegan and cannot eat eggs.	Ella es vegana y no puede comer huevos.	
The Adidas factory produced a lot of shoes this year.	La fábrica de Adidas produjo muchos zapatos este año.	
During the investigation, the police found evidence of the crime.	Durante la investigación, la policía encontró evidencia del crimen.	
The president gave a powerful speech last night.	El presidente dio un discurso poderoso anoche.	
"Can you turn the music down? It's too loud."	¿Puedes bajarle a la música? Está muy fuerte.	
I cannot tell what the book is about from the title.	No puedo decir de qué trata el libro por el título.	
The farmer planted a handful of seeds.	El agricultor plantó un puñado de semillas.	
Even though it is possible, I think it is unlikely.	Aunque es posible, creo que es poco probable.	
In order to go the party, Nicole lied to her mother.	Para ir a la fiesta Nicole le mintió a su madre.	
She highly values intellectual pursuits.	Ella valora mucho los propósitos intelectuales.	
The recipe says to add olive oil.	La receta dice agregar aceite de oliva.	
Is it dark outside? -- No, it is still sunny.	¿Está oscuro afuera? -- No, todavía hay sol.	
Jill bought two dozen (24) eggs.	Jill compró dos docenas (24) de huevos.	
Their parents trusted her with their new car.	Sus padres le confiaron su auto nuevo.	
He made an unexpected comment during the meeting.	Él hizo un comentario inesperado durante la reunión.	
What does it feel like to speak another language?	¿Qué se siente hablar otro idioma?	
I turned on the light before going up the stairs.	Encendí la luz antes de subir por las escaleras.	
Running is my favorite activity in the summertime.	Correr es mi actividad favorita en el verano.	
"He has a motorcycle, but doesn't have a helmet."	Él tiene una motocicleta, pero no tiene un casco.	
Water freezes at zero (0˚) Celsius.	El agua se congela a los cero grados (0º) Celsius.	
Smoking has a negative impact on your health.	Fumar tiene un impacto negativo en su salud.	
Was it snowing when we fell asleep?	¿Estaba nevando cuando nos quedamos dormidos?	
What time did the box leave the mail room?	¿A qué hora se fue la caja de la oficina de correos?	
It left around six a.m. (6:00) this morning.	Se fue alrededor de las seis (6:00) esta mañana.	
"Your card didn't arrive in the mail today."	Su tarjeta no llegó en el correo de hoy.	
Fred is sad. He and his girlfriend just broke up.	Fred está triste. Él y su novia acaban de terminar.	
In the United States, you need to be 21 to purchase wine.	En los Estados Unidos, usted debe tener 21 años para comprar vino.	
I usually am awake before seven am (7:00).	Normalmente estoy despierto antes de las siete de la mañana (7:00).	
We got up after five-thirty a.m. (5:30).	Nos levantamos después de las cinco y media de la mañana (5.30)	
The deadline to check out of the hotel is 11am.	El límite para salir del hotel es a las 11:00 a.m.	
I need to control my weight by eating less.	Necesito controlar mi peso comiendo menos.	
It has been snowing since last Tuesday.	Ha estado nevando desde el martes pasado.	
Where was Brad skateboarding when the sun came out?	¿En dónde estaba patinando Brad cuando salió el sol?	
I caught a cold, but it is pretty mild.	Me agarré un resfrío, pero es bastante leve.	
The teacher is the person with the most authority in the classroom.	El maestro es la persona con mayor autoridad en el aula.	
I am capable of becoming a doctor one day.	Soy capaz de convertirme en médico algún día.	
My parents think that I watch TV too much.	Mis padres piensan que veo demasiada televisión.	
In order to save money, you first need a budget.	Para ahorrar dinero, primero necesita un presupuesto.	
I dropped my phone in the toilet by accident.	Dejé caer mi teléfono en el baño por accidente.	
Was she browsing Instagram when I messaged her?	¿Ella estaba navegando en Instagram cuando le envié un mensaje?	
We loved the birthday celebration last weekend.	Nos encantó el festejo de cumpleaños el fin de semana pasado.	
She owns three cats and two dogs.	Ella posee tres gatos y dos perros.	
"She's in the kitchen. She's not cooking though."	Ella está en la cocina. Aunque no está cocinando.	
I understand the general idea but not the specific details.	Entiendo la idea general pero no los detalles específicos.	
"This is a complete collection of Mozart's works."	Esta es una colección completa de las obras de Mozart.	
The law firm employs a lot of lawyers.	La firma de abogados emplea a muchos abogados.	
He fired him for showing up to work late.	Lo despidió por haber llegado tarde al trabajo.	
I want to learn a new language every three years.	Quiero aprender un nuevo idioma cada tres años.	
I used a snorkel to breath underwater.	Usé un snórkel para respirar bajo el agua.	
Can you name the planets in our solar system?	¿Puede nombrar los planetas en nuestro sistema solar?	
"He had a notebook, but didn't have a pencil."	Él tenía un cuaderno, pero no tenía lápiz.	
"She's just gotten in touch with her father."	Ella acaba de ponerse en contacto con su padre.	
Please look away when I type my password.	Por favor, mire hacia otro lado cuando escribo mi contraseña.	
There are a lot of students in my biology class.	Hay muchos estudiantes en mi clase de biología.	
Highways connect people from different towns.	Las autopistas conectan a personas de diferentes ciudades.	
"I can't wait to see flowers again in the spring."	No puedo esperar para ver flores otra vez en la primavera.	
He played volleyball last night, and he won.	Él jugó volleyball anoche, y ganó.	
That sort of behavior is not allowed at this school.	Ese tipo de comportamiento no está permitido en esta escuela.	
The scissors are not pretty, but they are reliable.	Las tijeras no son bonitas, pero son confiables.	
Should I buy a house or should I rent one?	¿Debo comprar una casa o debo alquilar una?	
Some people think the number thirteen is unlucky.	Algunas personas piensan que el número trece es de mala suerte.	
Have you been to Burma? -- Yes, I was there four (4) years ago.	¿Has estado en Burma? -- Sí, estuve ahí hace cuatro (4) años.	
Mary is an author. She writes a lot of books.	Mary es una autora. Ella escribe muchos libros.	
My doctor told me that my heart is healthy.	Mi doctor me dijo que mi corazón está saludable.	
Is she married? How long has she been married?	¿Ella esta casada? ¿Cuánto tiempo lleva casada?	
"Her contribution was vital to the company's success."	Su contribución fue vital para el éxito de la compañía.	
How did your father react to the bad news?	¿Cómo reaccionó su padre ante las malas noticias?	
The outer seats at the stadium are cheaper.	Los asientos exteriores en el estadio son más baratos.	
We do a lot of different things in our free time.	Hacemos muchas cosas diferentes en nuestro tiempo libre.	
After we signed the papers, the house was ours.	Después de que firmamos los documentos, la casa era nuestra.	
"I drink tea, but I don't drink coffee."	Tomo té, pero no tomo café.	
"They've been waiting since seven o'clock (7:00)."	Ellos han estado esperando desde las siete (7:00).	
"You can speak to Jeff because he hasn't left yet."	Puedes hablar con Jeff porque aún no se ha ido.	
Have you ever met a professional basketball player?	¿Alguna vez conociste a un jugador profesional de basquetbol?	
What is the best way to study for a hard exam?	¿Cuál es la mejor manera de estudiar para un examen difícil?	
The music is too loud. Can you lower the volume?	La música está muy alta. ¿Puede bajar el volumen?	
The restaurant usually opens at eight (8:00) in the morning.	El restaurante normalmente abre a las ocho (8:00) de la mañana.	
My father works at a large digital agency.	Mi padre trabaja en una gran agencia digital.	
Though she is not particularly happy, she is content.	Aunque ella no es particularmente feliz, está contenta.	
I see three dogs and two cats in the picture.	Veo tres perros y dos gatos en la imagen.	
We used to own a motorcycle, but we sold it.	Teníamos una motocicleta, pero la vendimos.	
Takashi has studied biology in college for two (2) years.	Takashi ha estudiado biología en la universidad por dos (2) años.	
How much does it cost to get a haircut in France?	¿Cuánto cuesta un corte de cabello en Francia?	
The foundation donated a lot of money to my university.	La fundación donó una gran cantidad de dinero a mi universidad.	
I mopped the floor until it was dry.	Limpié el piso hasta que estuviera seco.	
You may discard your trash in the bin.	Usted puede tirar la basura en el contenedor.	
You can turn off the computer. The internet is not working.	Puedes apagar la computadora. El internet no está funcionando.	
An important factor in real estate is location.	Un factor importante en el sector inmobiliario es la ubicación.	
There are multiple explanations to how it all happened.	Hay múltiples explicaciones de cómo sucedió todo.	
With the right treatment, your disease will be cured.	Con el tratamiento adecuado, su enfermedad se curará.	
These are some basic sentences you should learn.	Estas son algunas oraciones básicas que debes aprender.	
The leaves change color in the fall where I live.	Las hojas cambian de color en el otoño donde vivo.	
Please bring a paper and pencil to the exam.	Por favor traiga un papel y un lápiz al examen.	
There is a mural of Martin Luther King on the cafeteria wall.	Hay un mural de Martin Luther King en la pared de la cafetería.	
"Was the internet working well? -- Yes, it's really fast."	¿El internet estaba funcionando bien? -- Sí, es muy rápido.	
Dillon was at the bus depot buying a ticket.	Dillon estaba en la central de autobuses comprando su boleto.	
It takes many years of training to become a doctor.	Se requieren muchos años de entrenamiento para convertirse en doctor.	
Michael Jordan had an excellent career as an athlete.	Michael Jordan tuvo una excelente carrera como atleta.	
Did Albert schedule your payment? -- Yes, he did.	¿Albert programó tu pago? -- Sí, lo hizo.	
There is a subtle crack on the windshield.	Hay una sutil grieta en el parabrisas.	
My mother makes me breakfast every morning.	Mi madre me hace el desayuno todas las mañanas.	
"Why wasn't she wearing shoes yesterday?"	¿Por qué ella no estaba usando zapatos ayer?	
The car is expensive. It costs a lot of money.	El coche es caro. Cuesta mucho dinero.	
"This is one of the artist's most creative works."	Esta es una de las obras más creativas del artista.	
"I'd like a room with two beds please."	Quisiera un cuarto con dos camas por favor.	
She has a close inner circle of friends.	Ella tiene un círculo interno de amigos.	
It is illegal to own a gun in some countries.	Es ilegal poseer un arma en algunos países.	
He sleeps nine (9) hours per night.	Él duerme nueve (9) horas cada noche.	
I wore a red t-shirt to school.	Yo llevaba una camiseta roja a la escuela.	
"I'd like to buy a bottle of water, please."	Quisiera comprar una botella de agua por favor.	
The car crashed into a telephone pole.	El auto se estrelló contra un poste de teléfono.	
"He's written forty (40) blog posts."	Él ha escrito cuarenta (40) publicaciones para blogs.	
The chemist works with toxic chemicals.	El químico trabaja con químicos tóxicos.	
The restaurant serves burgers and fries.	El restaurante sirve hamburguesas y papas fritas.	
On this side of the river, there is a small farm.	En este lado del río hay una pequeña granja.	
If your symptoms persist, see a doctor.	Si sus síntomas persisten consulte a un médico.	
"What is the most ridiculous thing that you've seen?"	¿Cuál es la cosa más ridícula que usted ha visto?	
Have they ever won a competition? -- No, not once.	¿Ellos han ganado alguna competencia? -- No, nunca.	
Are the benefits of exercise permanent or temporary?	¿Los beneficios del ejercicio son permanentes o temporales?	
Are there any famous events happening in May?	¿Hay algún evento famoso que ocurra en mayo?	
How do you organize your busy schedule?	¿Cómo organiza su apretada agenda?	
"Are Isaac or Kurt here? -- No, they've yet to arrive."	¿Isaac y Kurt estan aquí? -- No, todavía no llegan.	
Do they live in the United Arab Emirates?	¿Ellos viven en los Emiratos Árabes Unidos?	
Doing illegal things can put you in prison.	Hacer cosas ilegales puede ponerlo en prisión.	
At what time did the bar close last night?	¿A qué hora cerró el bar anoche?.	
Can I trade my pencil for your pen?	¿Puedo intercambiar mi lápiz por tu lapicero?	
"I've previously seen him here. His name is Bobby."	Lo he visto antes por aquí. Su nombre es Bobby.	
I expect to see fireworks during the parade.	Espero ver fuegos artificiales durante el desfile.	
I deposited the check into my bank account.	Deposité el cheque en mi cuenta bancaria.	
I passed the test but the rest of the school failed.	Pasé la prueba pero el resto de la escuela falló.	
"You should buy that tie. It's a good deal."	Deberías comprar esa corbata. Es una buena oferta.	
I brush my teeth three times a day.	Me cepillo los dientes tres veces al día.	
There is a lot of empty space at my home.	Hay mucho espacio vacío en mi casa.	
The magician revealed how he did the trick.	El mago reveló cómo hizo el truco.	
I work hard. How about Shu? Does he work hard?	Trabajo duro. ¿Y Shu? ¿Él trabaja duro?	
When did Nate arrive in China?	¿Cuándo llegó Nate a China?	
She arrived in China four (4) days ago.	Ella llegó a China hace cuatro (4) días.	
Was Laura occupied when you visited her?	¿Laura estaba ocupada cuando la visitaste?	
Yes, she was practicing for an exam.	Sí, estaba practicando para un examen.	
Was Maria at the office this morning?	¿María estaba en la oficina esta mañana?	
Yes, she was busy preparing for the presentation.	Sí, estaba ocupada preparándose para la presentación.	
California is in the western half of the United States.	California se encuentra en la mitad occidental de los Estados Unidos.	
The recent advances in technology are remarkable.	Los avances recientes en tecnología son notables.	
"She knows Spanish, but she doesn't know Italian."	Ella sabe español, pero no sabe italiano.	
Do universal hand gestures exist?	¿Existen gestos de manos universales?	
Does he always wake up before the sun?	¿Él siempre se levanta antes de que salga el sol?	
They bought a new truck last weekend.	Ellos compraron un nuevo camión el fin de semana pasado.	
Does your father ever visit the cinema?	¿Tu papá alguna vez va al cine?	
Do you think that electric cars are the future?	¿Usted cree que los autos eléctricos sean el futuro?	
I pulled on the door but it would not open.	Tiré de la puerta pero no se abrió.	
She starts at five thirty (5:30) in the morning.	Ella empieza a las cinco y media (5:30) de la mañana.	
What does your daily routine look like?	¿Cómo es su rutina diaria?	
How long has she lived in your apartment?	¿Cuánto tiempo lleva ella viviendo en tu apartamento?	
I know a lot about history. I like it a lot.	Sé mucho de historia. Me gusta mucho.	
Would you prefer it if I used headphones?	¿Preferiría que use auriculares?	
"He arrived on Wednesday. Today's Friday."	Él llegó el miércoles. Hoy es viernes.	
Water freezes at zero degrees.	El agua se congela a cero grados.	
I would like a small cup of coffee, please.	Me gustaría una pequeña taza de café, por favor.	
Virtual reality is an exciting technology.	La realidad virtual es una tecnología emocionante.	
"I hit my head but I don't see blood."	Me golpeé la cabeza pero no veo sangre.	
"You've lived in Pittsburg for quite some time now."	Has vivido en Pittsburg desde hace bastante tiempo.	
Ben usually plays basketball on Saturdays.	Ben usualmente juega basketball los sábados.	
"She doesn't like hip-hop music."	A ella no le gusta el hip-hop.	
I took four years to graduate from the university.	Me tomó cuatro años graduarme de la universidad.	
Where was she working in two-thousand six (2006)?	¿Ella en dónde estaba trabajando en el dos mil seis (2006)?	
"What time is Earl getting here? -- He's already here."	¿A qué hora llega Earl? -- Él ya está aquí.	
The best way to avoid crisis is prevention.	La mejor manera de evitar una crisis es la prevención.	
I would like to reserve a table at the restaurant.	Me gustaría reservar una mesa en el restaurante.	
My mother has lived there for five years.	Mi madre ha vivido ahí durante cinco años.	
There are multiple correct answers to the question.	Hay múltiples respuestas correctas a la pregunta.	
I wore an orange suit to the party.	Llevé un traje naranja a la fiesta.	
The water from the fountain tastes horrible.	El agua de la fuente sabe horrible.	
Who do you think is the best candidate for the job?	¿Quién cree que sea el mejor candidato para el trabajo?	
I drink a cup of coffee every morning.	Yo bebo una taza de café cada mañana.	
The train ticket cost eight dollars ($8).	El boleto de tren costó ocho dólares ($8).	
What do you think is the best scientific discovery?	¿Cuál cree usted que sea el mejor descubrimiento científico?	
Did you already forget what I told you to do?	¿Ya olvidó lo que le dije que hiciera?	
"Does she play the guitar? -- No, she doesn't."	¿Ella toca la guitarra? -- No, no la toca.	
The violent movie was not suitable for children.	La película violenta no era apta para niños.	
She tries to avoid large crowds.	Ella trata de evitar grandes multitudes.	
I try to avoid conflict at all costs.	Intento evitar el conflicto a toda costa.	
I would like to buy three apples, please.	Me gustaría comprar tres manzanas, por favor.	
Was your quiz hard? -- No, it was simple.	¿Estuvo difícil tu examen? -- No, estuvo fácil.	
If you need my help, please let me know.	Si necesitas mi ayuda, por favor házmelo saber.	
"They're feeling sick. They have headaches."	Ellos se sienten mal. Les duele la cabeza.	
It was snowing when the plane landed.	Estaba nevando cuando el avión aterrizó.	
"What were you cooking at ten o'clock (10:00)?"	¿Qué estabas cocinando a las diez (10:00)?	
How long have they been computer programmers?	¿Desde hace cuánto son programadores de computadoras?	
His success stems from his hard work.	Su éxito proviene de su arduo trabajo.	
Do you visit small cities? -- Yes, I do.	¿Visitas ciudades pequeñas? -- Sí, lo hago.	
My silk shirt is very delicate.	Mi camisa de seda es muy delicada.	
Jimbo is tired. He wants to go to sleep now.	Jimbo está cansado. Ya quiere irse a dormir.	
The structure of the Eiffel Tower is interesting.	La estructura de la Torre Eiffel es interesante.	
The garden is full of poisonous snakes.	El jardín está lleno de serpientes venenosas.	
Education gives us hope for a better life.	La educación nos da esperanza para una vida mejor.	
Do you watch videos often? -- Yes, I do.	¿Ves videos frecuentemente? -- Sí, lo hago.	
Are your hands cold? -- No, they are warm.	¿Tus manos están frías? -- No, están calientes.	
Kai broke her leg two weeks ago.	Kai se rompió la pierna hace dos semanas.	
She is the most valuable player on her team.	Ella es la jugadora más valiosa en su equipo.	
"Have you read the author's literary works?"	¿Usted ha leído las obras literarias del autor?	
I used to see him often, but he moved to Los Angeles.	Solía verlo a menudo, pero se mudó a Los Ángeles.	
I feel like I have the support I need to succeed.	Siento que tengo el apoyo que necesito para ser exitoso.	
Have they ever ridden in a Tesla? -- No, not once.	¿Ellos han viajado en un Tesla? -- No, nunca.	
She never likes to travel by subway.	A ella nunca le gusta viajar en metro.	
Brian and I are lovers. I know him intimately.	Brian y yo somos amantes. Lo conozco íntimamente.	
I am meeting a couple of people in an hour.	Me reuniré con un par de personas en una hora.	
We have a thousand dollars in the bank account.	Tenemos mil dólares en la cuenta bancaria.	
My parents supported me through a difficult time.	Mis padres me apoyaron en un momento difícil.	
"I'd like to buy a phone card please."	Quisiera una tarjeta de teléfono, por favor.	
How much water do you drink each day?	¿Cuánta agua bebe usted cada día?	
Life was simpler when he was just a boy.	La vida era más sencilla cuando él era niño.	
If I speak more, my speaking will improve.	Si hablo más, mi habla mejorará.	
I want to buy an external hard drive.	Quiero comprar un disco duro externo.	
"I'm watching TV now. I'm not working."	Estoy viendo la televisión. No estoy trabajando.	
The genie granted him three wishes.	El genio le concedió tres deseos.	
Did anybody see Fred yesterday? -- Yes, I did.	¿Alguien vio a Fred ayer? -- Sí, lo vi.	
I lost my wallet at the train station.	Perdí mi billetera en la estación de tren.	
"But he's not currently running around the track."	Pero en este momento no está corriendo por la pista.	
Can you hear the noise coming from the kitchen?	¿Puede oír el ruido que viene de la cocina?	
I am sad that I have to leave so soon.	Estoy triste de tener que irme tan pronto.	
Do you prefer to be mainstream or alternative?	¿Usted prefiere ser convencional o alternativo?	
The teacher graded her students fairly.	La maestra calificó a sus estudiantes justamente.	
You can get an excellent education at that university.	Puedes obtener una educación excelente en la universidad.	
Maria enjoys playing tennis on the weekends.	María disfruta jugar al tenis los fines de semana.	
Culture is an important part of language learning.	La cultura es una parte importante del aprendizaje de idiomas.	
How would you compare the two software products?	¿Cómo compararía los dos productos de software?	
What is the influence of other cultures on a nation?	¿Cuál es la influencia de otras culturas en una nación?.	
Please stay on the road while you are driving.	Por favor permanezca en el camino mientras conduce.	
They realized that the strawberries were on sale.	Se dieron cuenta de que las fresas estaban en venta.	
How common is fast food where you live?	¿Qué tan común es la comida rápida donde vives?	
"They've been waiting for ninety (90) minutes."	Ellos han estado esperando por noventa (90) minutos.	
When I was nineteen, I studied at the university.	Cuando tenía diecinueve años estudié en la universidad.	
How many hours per day do you study?	¿Cuántas horas por día estudia?	
The author quoted Shakespeare in his latest novel.	El autor citó a Shakespeare en su última novela.	
It is okay if you arrive late to the party.	Está bien si llegas tarde a la fiesta.	
The process of getting American citizenship is long and difficult.	El proceso de obtener la ciudadanía americana es largo y difícil.	
My schedule is very flexible this Tuesday.	Mi horario es muy flexible este martes.	
The restaurant has outdoor seating available.	El restaurante tiene asientos al aire libre disponibles.	
The new TV cost three hundred dollars.	El nuevo televisor cuesta trescientos dólares.	
This pen uses invisible ink.	Este bolígrafo usa tinta invisible.	
What is the best way to earn a lot of money?	¿Cuál es la mejor forma de ganar mucho dinero?	
We talked to him yesterday in the living room	Hablamos con él ayer en la sala.	
What is the best way to determine the value of a house?	¿Cuál es la mejor manera de determinar el valor de una casa?	
I bought this shirt three (3) weeks ago.	Compré esta playera desde hace tres (3) semanas.	
"I'm sorry, I don't get it. Can you repeat that?"	Perdón, no entiendo. ¿Puede repetirlo?	
At seven-fifty (7:50), he was reading a book.	A las siete cincuenta (7:50), él estaba leyendo un libro.	
How much does gas cost in your country?	¿Cuánto cuesta la gasolina en su país?.	
When I return home, I will cook dinner.	Cuando regrese a casa, cocinaré la cena.	
The deer had already been dead for weeks.	El venado ya había estado muerto por semanas.	
I forgot my password again last night.	Anoche olvidé mi contraseña de nuevo.	
What is the best way to peel a carrot?	¿Cuál es la mejor manera de pelar una zanahoria?	
How long have they been sitting on the couch?	¿Cuánto tiempo han estado sentados en el sofá?	
"The milkman hasn't come yet today."	El lechero aún no ha llegado.	
We made a lot of brownies last night.	Hicimos muchos brownies anoche.	
On what basis do I deserve this punishment?	¿Sobre qué base merezco este castigo?.	
Is the moon visible on a cloudy night?	¿La luna es visible en una noche nublada?	
It is a minor detail that can be ignored.	Es un detalle menor que puede ignorarse.	
"Kabir's in Portland. He's been there for at least four (4) days."	Kabir está en Portland. Está ahí desde hace al menos cuatro (4) días.	
The cat was scared by the sudden noise.	El gato estaba asustado por el ruido repentino.	
The audience laughed throughout the comedy show.	La audiencia se rió durante el show de comedia.	
Did you make an effort to go to work today?	¿Hizo un esfuerzo para ir a trabajar hoy?.	
"You've been early for work almost everyday."	Tú has llegado temprano al trabajo casi siempre.	
We often have dinner at seven thirty (7:30).	Normalmente cenamos a las siete y media (7:30).	
At two-twenty (2:20), he was cooking soup.	A las dos veinte (2.20), él estaba cocinando sopa.	
"The doctor's patient has a terrible disease."	El paciente del doctor tiene una terrible enfermedad.	
My shoulder hurts from playing baseball.	Me duele el hombro por jugar al béisbol.	
At what temperature does butter melt?	¿A qué temperatura se derrite la mantequilla?	
Sometimes he feels a little bit lonely.	A veces él se siente un poco solo.	
"Please remember to take your medicine. It's important."	Por favor, recuerde tomar su medicamento. Es importante.	
The multinational company employs a lot of people.	La compañía multinacional emplea a mucha gente.	
Roger Bannister broke the world record for running a mile.	Roger Bannister rompió el récord mundial al correr una milla.	
Please fill out the form when you have the chance.	Por favor complete el formulario cuando tenga la oportunidad.	
I have a lot of reasons to learn a new language.	Tengo muchas razones para aprender un nuevo idioma.	