The coal plant created many jobs for the village.	La planta de carbón creó muchos trabajos para el pueblo.	
Every year, the prices at the grocery store increase.	Cada año los precios en la tienda de comestibles aumentan.	
"He's a high school teacher. He teaches science."	Él es maestro de secundaria. Enseña ciencias.	
That company is unlike any other company that I have seen.	Esa compañía es diferente a cualquier otra compañía que yo haya visto.	
Should I wrap the gift or put it in a bag?	¿Debo envolver el regalo o ponerlo en una bolsa?	
I think that going to the conference would be a great opportunity for you.	Creo que ir a la conferencia sería una gran oportunidad para usted.	
I was able to help my client buy a new house.	Pude ayudar a mi cliente a comprar una casa nueva.	
We own many books, and have read every single one.	Tenemos muchos libros, y los hemos leído todos y cada uno de ellos.	
He attempted to steal from the store, but was arrested.	Él intentó robar de la tienda, pero fue arrestado.	
That movie had a great director and great actors too.	Esa película tenía un gran director y grandes actores también.	
I contributed to the charity because I believed in their cause.	Contribuí a la caridad porque creí en su causa.	
How long did it take them to prepare for the vacation?	¿Cuánto tiempo les llevó a ellos prepararse para las vacaciones?	
I remember the first time I learned to ride a bicycle.	Recuerdo la primera vez que aprendí a manejar una bicicleta.	
"It's hard to score a goal against that goalie."	Es difícil anotar un gol contra ese portero.	
"Joe is still in the hospital, so he's unavailable at the moment."	Joe todavía está en el hospital, así que no está disponible por el momento.	
How well do you retain information after you learn it?	¿Qué tan bien retiene la información después de aprenderla?	
I cannot open the jar of pasta sauce.	No puedo abrir el frasco de salsa para pasta.	
Monday was a holiday, so the post office was closed.	El Lunes era día festivo, así que la oficina de correos estaba cerrada.	
He went to prison after committing many crimes.	Él fue a prisión después de cometer muchos crímenes.	
"When I was growing up, I didn't use to like vegetables."	Cuando era más joven, no me gustaban los vegetales.	
February has fewer days than any other month.	Febrero tiene menos días que cualquier otro mes.	
The children traced different shapes with a pencil.	Los niños trazaron diferentes formas con un lápiz.	
The doctor has worked at this hospital for twenty years.	El doctor ha trabajado en este hospital por veinte años.	
When did Ben leave? -- He left twelve (12) minutes ago.	¿A qué hora se fue Ben? -- Se fue desde hace doce (12) minutos.	
Because of financial problems, George needed to take out a loan.	Debido a problemas financieros, George necesitó sacar un préstamo.	
You will see immediate results after taking the pill.	Usted verá resultados inmediatos después de tomar la pastilla	
She graduated from high school ten years ago.	Ella se graduó de la escuela secundaria hace diez años.	
"He wants to go to the show, but he doesn't have a ticket."	Él quiere ir al show, pero no tiene boleto.	
How do you measure your weight in outer space?	¿Cómo mide uno su peso en el espacio exterior?	
A key aspect of a healthy lifestyle is exercise.	Un aspecto clave de un estilo de vida saludable es el ejercicio.	
The police chased the thief until he was caught.	La policía persiguió al ladrón hasta que fue atrapado.	
What activities did you enjoy when you were growing up?	¿Qué te gustaba hacer cuando eras joven?	
I hope they extend the deadline for the job application.	Espero que extiendan el plazo para la aplicación de empleo.	
If we do not make progress, we will fall behind.	Si no hacemos progreso, nos quedaremos atrás.	
"When I was a baby, I couldn't eat solid food."	Cuando era bebé, no podía comer comida sólida.	
He acts modest even though he is a genius.	Él actúa modesto a pesar de que es un genio.	
"Where's his coat? -- I don't know. He doesn't have it."	¿Dónde está su abrigo? -- No sé. Él no lo tiene.	
YouTube is an excellent website for watching videos.	YouTube es un excelente sitio web para ver videos.	
This restaurant accepts all major credit cards.	Este restaurante acepta todas las tarjetas de crédito más importantes.	
"These chairs aren't beautiful, but they're comfortable."	Estas sillas no están bonitas, pero son muy cómodas.	
"Anthony hasn't taken a week off from work in three (3) years."	Anthony no ha tomado ni una semana de vacaciones del trabajo en tres (3) años.	
I see a lot of students in the hall during recess.	Veo a muchos estudiantes en el pasillo durante el recreo.	
She has a full-time job and takes care of the kids.	Ella tiene un trabajo de tiempo completo y se ocupa de los niños.	
My family had a discussion about finances last night.	Mi familia tuvo anoche una discusión sobre las finanzas.	
"She isn't hungry. She isn't eating right now."	Ella no tiene hambre. No va a comer ahora.	
The theater performance was excellent because of the amazing director.	La actuación en el teatro fue excelente debido al sorprendente director.	
"My son is shy and doesn't speak very often."	Mi hijo es tímido y no habla muy a menudo.	
Before you donate blood, what is your blood type?	Antes de donar sangre, ¿cuál es su tipo de sangre?.	
Have they ever eaten a pear? -- No, not once.	¿Ellos alguna vez han comido una pera? -- No, nunca.	
We were separated into two groups based on age.	Fuimos separados en dos grupos según la edad.	
I review my credit card statement every month.	Yo reviso el estado de mi tarjeta de crédito todos los meses.	
Solomon went to the pizza shop three (3) times last week.	Salomón fue a la pizzería tres (3) veces la semana pasada.	
"When I went to the store, they didn't have any apples."	Cuando fui a la tienda, no tenían manzanas.	
After you enter the museum, you will see many paintings.	Después de ingresar al museo verá muchas pinturas.	
"The surgeon's knowledge of anatomy was astounding."	El conocimiento del cirujano sobre anatomía fue asombroso.	
AJ started her new job one (1) year ago.	AJ empezó su nuevo trabajo desde hace un (1) año.	
I developed an interest in sports at an early age.	Desarrollé un interés en los deportes a una edad temprana.	
"Do you know this man? -- No, I've never met this man."	¿Conoces a este hombre? -- No, nunca lo había visto.	
The textbook was helpful in explaining these concepts.	El libro de texto fue útil para explicar estos conceptos.	
"Have they visited Southeast Asia? -- Yes, they've visited twice."	¿Ellos han visitado el sureste de Asia? -- Sí, lo han visitado dos veces.	
During the presidential election, many people forgot to vote.	Durante las elecciones presidenciales, muchas personas olvidaron votar.	
I think that society should discuss environmental issues more.	Creo que la sociedad debería debatir más sobre cuestiones ambientales.	
I sent you a text message yesterday. Did you get it?	Le envié un mensaje de texto ayer. ¿Lo recibió?.	
He programs iPhone apps in his spare time.	Él programa aplicaciones de iPhone en su tiempo libre.	
We took a four (4) week vacation two (2) years ago.	Nosotros nos tomamos cuatro (4) semanas de vacaciones hace dos (2) años.	
My friend is a singer, and has recorded many songs.	Mi amiga es cantante y ha grabado muchas canciones.	
"Rosa Parks played a huge role in the Women's Rights movement."	Rosa Parks jugó un papel muy importante en el movimiento por los derechos de las mujeres.	
"It's snowing. I don't want to freeze in the snow."	Está nevando. No me quiero congelar en la nieve.	
The northern region of Canada is cold all year round.	La región norte de Canadá es fría durante todo el año.	
He was jogging at eight-thirty (8:30) last night.	Él estaba corriendo a las ocho y media (8:30) anoche.	
"My job is very boring. I don't talk to many people."	Mi trabajo es muy aburrido. No hablo con muchas personas.	
They were playing basketball when I was cooking dinner.	Ellos estaban jugando basquetbol mientras preparaba la cena.	
After I passed the test, my body felt lighter.	Después de haber pasado el examen mi cuerpo se sintió más ligero.	
How much are these apples?	¿Cuánto cuestan estas manzanas?	
Two dollars fifty a kilogram ($2.50/kg).	Dos dólares con cincuenta el kilo. ($2.50/kg).	
I like to drink my coffee with cream and sugar.	Me gusta tomar mi café con crema y azúcar.	
I am grateful to have clean water at my house.	Estoy agradecido de tener agua limpia en mi casa.	
I have a bit of free time right now. Can we talk?	Tengo un poco de tiempo libre en este momento. ¿Podemos hablar?.	
"When does Shu start school? -- He's already started school."	¿Cuándo empieza Shu la escuela? -- Él ya empezó la escuela.	
"What was she doing at eight o'clock (8:00) this morning?"	¿Qué estaba haciendo ella a las ocho (8:00) de la mañana?	
He wore a t-shirt and jeans to school.	Él llevaba puestos una camiseta y unos jeans a la escuela.	
Can you help me load the groceries in the trunk?	¿Puede ayudarme a cargar los alimentos en el maletero?	
"I lost my key, so I can't enter my house."	Perdí mi llave, así que no puedo entrar a mi casa.	
The children threw paper airplanes in the playground.	Los niños lanzaron aviones de papel en el patio de juego.	
Are you thirsty? -- Yes, want to grab a beer?	¿Tienes sed? -- Sí, ¿Quieres tomar una cerveza?	
The presence of firearms is strictly prohibited here.	La presencia de armas de fuego está estrictamente prohibida aquí.	
The new shirt looks great, but it does not fit.	La nueva camiseta se ve genial, pero no se ajusta.	
Samantha seems to be complaining a lot recently.	Samantha parece estarse quejando mucho últimamente.	
The ability to follow instructions is very important for the job.	La capacidad de seguir instrucciones es muy importante para el trabajo.	
What would you buy if you had one hundred dollars?	¿Qué compraría si tuvieras cien dólares?	
Can you send me an email with the details of the event?	¿Me puede enviar un correo electrónico con los detalles del evento?	
"What's the password? -- I've forgotten it. I forgot it."	¿Cuál es la contraseña? -- La he olvidado. La olvidé.	
It is rude to stare for too long at someone.	Es descortés mirar fijamente por mucho tiempo a alguien.	
"She lives near me, but I don't usually see her."	Ella vive cerca de mí, pero casi no la veo.	
He was going to the airport, and he was carrying a backpack.	Él iba hacia el aeropuerto y estaba cargando una mochila.	
The tenants have occupied the building for over a decade.	Los inquilinos han ocupado el edificio por más de una década.	
I carried the box up three flights of stairs.	Llevé la caja por tres tramos de escaleras.	
I cannot list all of the possibilities. There are too many.	No puedo enumerar todas las posibilidades. Hay demasiadas.	
Is it dangerous to go outside at night where you live?	¿Es peligroso salir en la noche donde vive?	
Eating too much salt is bad for your health.	Comer demasiada sal es malo para su salud.	
I really like the material that I learned in the philosophy class.	Me gusta mucho el material que aprendí en la clase de filosofía.	
I apologize for the delay. How long have you been here?	Disculpa el retraso. ¿Cuánto tiempo llevas aquí?	
You own a car. How long has she had your car?	Tú tienes un coche. ¿Cuánto tiempo tuvo ella tu coche?	
Please remove your shoes when you enter the room.	Por favor quítese los zapatos cuando entre al cuarto.	
We were cold during the vacation, but we were happy.	Teníamos frío durante las vacaciones, pero estábamos felices.	
I think that it is important to talk about racial issues.	Creo que es importante hablar sobre cuestiones raciales.	
How do I install the app onto my phone?	¿Cómo instalo la aplicación en mi teléfono?	
"Is Chris there? -- No, he's out shopping. He went shopping."	¿Está Chris ahí? -- No, él está de compras. Él salió de compras.	
I admire her ability to sing high notes.	Admiro su habilidad para cantar notas altas.	
She spent her annual bonus on a new car.	Ella gastó su bonificación anual en un auto nuevo.	
Lulu showers every evening at nine (9:00).	Lulu se baña todas las noches a las nueve (9:00).	
What is the standard way to greet someone in your country?	¿Cuál es la forma estándar de saludar a alguien en su país?	
The store sells fresh fruits and vegetables.	La tienda vende frutas y verduras frescas.	
Where did you get that watch? -- I bought it online.	¿Dónde conseguiste ese reloj? -- Lo compré en línea.	
The judge sentenced him to five years in prison.	El juez lo sentenció a cinco años de prisión.	
How do you feel about living in a rural area?	¿Cómo se siente al vivir en un área rural?	
The best way to learn languages is to start speaking.	La mejor forma de aprender idiomas es empezando a hablar.	
Did the sun shine yesterday? -- Yes, it did.	¿El sol brilló ayer? -- Sí, lo hizo.	
Creating a successful business involves hard work.	Crear un negocio exitoso implica trabajo duro.	
The construction worker painted the walls grey.	El trabajador de la construcción pintó las paredes grises.	
The newlyweds were enjoying their honeymoon in Belize.	Los recién casados estaban disfrutando de su luna de miel en Belice.	
The interest rate was low, so we bought the house.	La tasa de interés era baja, así que compramos la casa.	
"Remember to text Daniel. -- I've already texted him."	Recuerda escribirle a Daniel. -- Ya le envié un mensaje.	
The teacher wanted everybody in his class to participate.	El maestro quería que todos en su clase participaran.	
You must press on the wound to stop the bleeding.	Debe presionar sobre la herida para detener el sangrado.	
I can relate to you because I grew up in Germany too.	Me puedo identificar con usted porque también crecí en Alemania.	
The snowstorm continued, so we stayed inside.	La tormenta de nieve continuó, así que nos quedamos adentro.	
It was a tough decision, but I have no regrets.	Fue una decisión difícil, pero no me arrepiento.	
"Melody's been learning Romanian for five (5) months."	Melody ha estado aprendiendo rumano desde hace cinco (5) meses.	
The events leading up to her death were tragic.	Los eventos que llevaron a su muerte fueron trágicos.	
Does he know her? How long has he known her?	¿Él la conoce? ¿Desde hace cuánto la conoce?	
The band played my favorite song last night.	La banda tocó mi canción favorita anoche.	
The press published a sensational article this morning.	La prensa publicó un artículo sensacionalista esta mañana.	
The biggest change of living in New York was the large crowds.	El mayor cambio de vivir en Nueva York fue la gran cantidad de gente.	
The bag of popcorn expands in the microwave.	La bolsa de palomitas de maíz se expande en el microondas.	
"We worked on Wednesday, but we didn't on Friday."	Trabajamos el miércoles pero no trabajamos el viernes.	
"We're great friends. I like her. She likes me."	Somos grandes amigos. Ella me agrada. Yo le agrado.	
What are the long-term effects of drinking alcohol?	¿Cuáles son los efectos a largo plazo del consumo de alcohol?	
Lulu prefers tea over coffee.	Lulu prefiere el té al café.	
Has he ever lost his ID? -- No, not once.	¿Alguna vez, él ha perdido su identificación? -- No, nunca.	
My uncle has lived in New Zealand for fourteen (14) years.	Mi tío ha vivido en Nueva Zelanda por catorce (14) años.	
"That is the most expensive diamond I've ever seen."	Ese es el diamante más caro que he visto.	
There are three ducks floating in the pond.	Hay tres patos flotando en el estanque.	
When I was a teenager, I wanted to be a filmmaker.	Cuando era adolescente, quería ser cineasta.	
I work at the technology company as a software engineer.	Trabajo en la compañía de tecnología como ingeniero de software.	
He folded the paper and put it in his pocket.	Él dobló el papel y lo puso en su bolsillo.	
Learning Spanish gives you an advantage in business.	Aprender español te da una ventaja en los negocios.	
The student was disappointed with his exam scores.	El estudiante estaba decepcionado con los puntajes de sus exámenes.	
I suppose that I could exercise more if I had the time.	Supongo que podría hacer más ejercicio si tuviera el tiempo.	
The clown slipped on the banana peel.	El payaso se resbaló en la cáscara de banana.	
Everyone thought he was guilty, but he was innocent.	Todos pensaban que él era culpable, pero él era inocente.	
As long as we are human, we will make mistakes.	Mientras seamos humanos, cometeremos errores.	
Did you notice the smoke coming out of your car?	¿Notó el humo saliendo de su auto?	
He is one of the best baseball players in the United States.	Él es uno de los mejores jugadores de béisbol en los Estados Unidos.	
Learning a new language creates international opportunities.	Aprender un nuevo idioma crea oportunidades internacionales.	
I need coffee every morning to stay awake.	Necesito café todas las mañanas para mantenerme despierto.	
My mother has a huge mansion by the ocean.	Mi madre tiene una enorme mansión frente al océano.	
How thin is a sheet of printer paper?	¿Qué tan delgada es una hoja de papel de impresora?	
"Do you know anyone that doesn't have a mobile phone?"	¿Conoce a alguien que no tenga un teléfono móvil?	
I cannot go to school today because I have a cold.	No puedo ir a la escuela hoy porque tengo un resfriado.	
The ability to build computers made Michael Dell very rich.	La capacidad para construir computadoras hizo que Michael Dell fuera muy rico.	
"Picasso's art can be found at the museum."	El arte de Picasso se puede encontrar en el museo.	
The report showed significant evidence of climate change.	El informe mostró evidencia significativa del cambio climático.	
He used to be fat, but then he lost weight.	Él solía ​​ser gordo, pero luego perdió peso.	
This jar stores my spare coins.	Este frasco almacena mis monedas extra.	
I would like to eliminate my pronunciation mistakes.	Me gustaría eliminar mis errores de pronunciación.	
My apartment has two bedrooms and one bathroom.	Mi apartamento tiene dos dormitorios y un baño.	
"Please use your inside voice. I'm concentrating."	Por favor guarda silencio. Me estoy concentrando.	
She kicked the soccer ball over the fence.	Ella pateó la pelota de fútbol sobre la valla.	
Chewing gum in class is against the rules.	Masticar chicle en clase está en contra de las reglas.	
There is a computer that you can use at the public library.	Hay una computadora que puedes usar en la biblioteca pública.	
The museum does not permit flash photography.	El museo no permite fotografía con flash.	
I rinsed my mouth with a cup of water.	Me enjuagué la boca con una taza de agua.	
When was the last time you were in a plane? -- Last month.	¿Cuándo fue la última vez que estuviste en un avión? -- El mes pasado.	
Did you watch the concert on YouTube last night?	¿Viste el concierto en Youtube anoche?	
Imagine a world where everybody has enough to eat.	Imagine un mundo donde todos tienen suficiente para comer.	
"At a quarter past one (1:15), she wasn't in the backyard."	A la una y cuarto (1:15), ella no estaba en el patio trasero.	
I advised him to stop doing drugs immediately.	Le aconsejé que dejara de consumir drogas inmediatamente.	
"He's married, and he always wears his ring."	Él está casado, y siempre trae puesto su anillo.	
I put the groceries in a brown paper bag.	Puse los comestibles en una bolsa de papel marrón.	
"Can you repeat the question? I didn't quite hear it."	¿Puede repetir la pregunta? No la escuché del todo.	
Keep going straight until you reach the intersection.	Siga recto hasta que llegue a la intersección.	
All it took was one look to know that he was guilty.	Todo lo que se necesitó fue una mirada para saber que él era culpable.	
"What's going on? -- I haven't heard from you lately."	¿Qué está pasando? -- No he oído de tí últimamente.	
The environment has been changing a lot in the last century.	El medio ambiente ha estado cambiando mucho en el último siglo.	
Do you see any ethical problems with your plan?	¿Ve algún problema ético con su plan?	
Did you mention that you had three older brothers?	¿Usted mencionó que tenía tres hermanos mayores?	
I am going through some personal problems right now.	Estoy pasando por algunos problemas personales en este momento.	
My grandfather has a huge collection of stamps.	Mi abuelo tiene una gran colección de estampillas.	
Very few people live in the northern half of Canada.	Muy pocas personas viven en la mitad norte de Canadá.	
The standard for formal attire is the tuxedo.	Lo estándar para la vestimenta formal es el esmoquin.	
"I am not yet eighteen, so I can't vote."	Todavía no tengo dieciocho años así que no puedo votar.	
"They haven't told anyone about their marriage yet."	Ellos no le han contado a nadie sobre su matrimonio.	
Does he run around the track? -- Yes, he runs.	¿Él corre por la pista? -- Sí, sí corre.	
Does the hotel include free continental breakfast?	¿El hotel incluye desayuno continental gratis?	
My aunt and uncle arrived last Thursday.	Mi tía y mi tío llegaron el jueves pasado.	
Cars must yield to pedestrians by law.	Los autos deben, por ley, ceder el paso a los peatones.	
How much cash does she have in her wallet?	¿Cuánto dinero trae ella en su cartera?	
The president used questionable tactics in his campaign.	El presidente utilizó tácticas cuestionables en su campaña.	
Nobody knows how to predict the stock market.	Nadie sabe cómo predecir el mercado de valores.	
My face is red because I am embarassed.	Mi cara está roja porque estoy avergonzado.	
The town is very remote and is not connected to the Internet.	La ciudad es muy remota y no está conectada a Internet.	
My boss is forcing me to work over the weekend.	Mi jefe me está forzando a trabajar durante el fin de semana.	
My father used an axe to cut the tree.	Mi padre usó un hacha para cortar el árbol.	
"Chelsea got a new job. See if she's already started."	Chelsea consiguió un nuevo trabajo. A ver si ya lo ha empezado.	
The teacher could not excuse her terrible behavior.	La maestra no pudo excusar su terrible comportamiento.	
Please wash your hands before returning to work.	Por favor lávese las manos antes de regresar al trabajo.	
We talked about various topics during the meeting.	Hablamos de varios temas durante la reunión.	
They struggled to divide the chores fairly.	Ellos lucharon por dividir las tareas de manera justa.	
"My iPhone's battery ran out of power."	La batería de mi iPhone se quedó sin poder.	
The deadline to submit the assignment is tomorrow night.	La fecha límite para enviar la tarea es mañana por la noche.	
Does he feel guilty for not leaving a tip?	¿Se siente culpable por no dejar propina?	
"Ben's grandfather has moved to the countryside."	El abuelo de Ben se mudó al campo.	
My winter coat protects me from the cold.	Mi abrigo de invierno me protege del frío.	
The Olympic runners compete every four years.	Los corredores olímpicos compiten cada cuatro años.	
The waitress poured the coffee into my cup.	La camarera vertió el café en mi taza.	
The concert was terrible so I wanted to leave early.	El concierto estuvo terrible, así que quería irme temprano.	
"And she finishes at nine o'clock (9:00) at night."	Y ella termina a las nueve (9:00) de la noche.	
When was the last time she went to the bank? -- Last week.	¿Cuándo fue la última vez que ella fue al banco? -- La semana pasada.	
I could not resist eating the chocolate cake.	No pude resistirme a comer el pastel de chocolate.	
I would like a medium cup of orange juice.	Me gustaría una taza mediana de jugo de naranja.	
"We're busy right now. Can I call you tomorrow?"	Estamos ocupados en este momento. ¿Puedo llamarte mañana?	
The growth of smartphones has made communication easier.	El crecimiento de los smartphones ha hecho fácil la comunicación.	
Going to the local university provided John an excellent education.	Ir a la universidad local le proporcionó a John una educación excelente.	
I moved the bags from my car to the living room.	Moví las bolsas de mi auto a la sala de estar.	
The so-called doctor lied about his credentials.	El así llamado doctor mintió sobre sus credenciales.	
The baseball player hit the ball with his bat.	El jugador de béisbol golpea la pelota con su bate.	
Why is he acting so aggressive all of a sudden?	¿Por qué él está actuando tan agresivamente de repente?	
The surgeon goes to the healthcare conference each year.	El cirujano acude a la conferencia de salud cada año.	
"You've lived in Pittsburg since you were six (6) years old."	Has vivido en Pittsburg desde los seis (6) años.	
Put all the ingredients in the pot, and then stir.	Ponga todos los ingredientes en la olla y luego revuelva.	
"There hasn't been a cloud in the sky all week."	No ha habido una nube en el cielo toda la semana.	
"She wasn't mindlessly browsing the web."	No estaba navegando sin pensar en la red.	
"We don't speak much. We don't have much time together."	No hablamos mucho. No tenemos mucho tiempo juntos.	
What are the most challenging problems that society faces?	¿Cuáles son los problemas más desafiantes que enfrenta la sociedad?	
Once the sun sets, the sky becomes dark.	Una vez que el sol se pone, el cielo se vuelve oscuro.	
Even though I disagree with you, I will not judge you.	Aunque estoy en desacuerdo con usted, no lo juzgaré.	
She used a hairdryer to dry her hair.	Ella usó un secador de pelo para secarse su cabello.	
Where did they play yesterday? -- They played in the park.	¿En dónde jugaron ayer? -- Ellos jugaron en el parque.	
"What does your brother do for work? -- He's a doctor."	¿En qué trabaja tu hermano? -- Es doctor.	
Our ribs protect our internal organs.	Nuestras costillas protegen nuestros órganos internos.	
"Rodrigo and Maria are married. They've been together for eight (8) years."	Rodrigo y María están casados. Han estado juntos por ocho (8) años.	
I forgot the meaning of the word, but I just remembered it.	Olvidé el significado de la palabra, pero simplemente lo recordé.	
I am consistent with going to the gym every morning.	Yo soy consistente en ir al gimnasio todas las mañanas.	
My back is in a lot of pain after the car accident.	Mi espalda tiene mucho dolor después del accidente en auto.	
Do you have a particular reason for choosing that restaurant?	¿Tiene una razón particular para elegir ese restaurante?	
I like to watch the leaves change color in autumn.	Me gusta ver las hojas cambiar de color en otoño.	
I arrived at the office at ten (10:00) and left at six (6:00).	Llegué a la oficina a las diez (10:00) y me fui a las seis (6:00).	
I was a child when I learned to ride a bicycle.	Yo era un niño cuando aprendí a manejar la bicicleta.	
Our country struggled for years to achieve independence.	Nuestro país luchó durante años para lograr la independencia.	
"He's studying Cantonese. -- How long has he been studying Cantonese?"	Él estudia Cantonés. -- ¿Cuánto tiempo ha estudiado Cantonés?	