Why are you laughing?	¿Por qué te estás riendo?	
"What's your address?"	¿Cuál es tu dirección?	
Will you remind me?	¿Me puedes recordar?	
I was going to the library.	Yo iba a ir a la librería.	
"It's warm today."	Hoy hace calor.	
"I don't have a girlfriend."	No tengo novia.	
"I'll be right back."	Ya regreso.	
When did this happen?	¿Cuándo pasó esto?	
Is your car red?	¿Tu coche es rojo?	
"No, it's blue."	No, es azul.	
The grass is green.	El pasto es verde.	
The city of Los Angeles is in the state of California.	La ciudad de los Ángeles está en el estado de California.	
I made this cake.	Yo hice este pastel.	
"That's my sandwich."	Ese es mi sándwich	
"No, it isn't."	No, no lo es.	
The books are expensive.	Los libros son caros.	
Do you have a boyfriend?	¿Tienes novio?	
Have you done this before?	¿Alguna vez habías hecho esto?	
"What's your religion?"	¿Cuál es tu religión?	
Do you like basketball?	¿Te gusta el basketball?	
Expiration date.	Fecha de expiración.	
Please sit down.	Por favor siéntate.	
Who won the competition?	¿Quién ganó la competencia?.	
"I'm twenty four (24)."	Tengo veinticuatro (24).	
"I've never done that."	Nunca he hecho eso.	
You look very young.	Usted se ve muy joven.	
"I don't have a boyfriend."	No tengo novio.	
Why are you crying?	¿Por qué estás llorando?	
"I don't like basketball."	No me gusta el basketball.	
"That's too expensive."	Eso es muy caro.	
Male or female?	¿Hombre o mujer?	
Please slow down.	Por favor reduzca la velocidad.	
I need to practice more.	Necesito practicar más.	
What do you recommend?	¿Que recomienda usted?	
I find that surprising.	Me parece sorprendente.	
Someone does that for me.	Alguién hace eso por mi.	
Can I take a message?	¿Puedo tomar un mensaje?	
When do you arrive?	¿Cuándo llegas?	
Where did you learn?	¿En dónde aprendiste?	
Where did it happen?	¿Dónde sucedió?	
"It isn't sunny."	No está soleado.	
Sorry to bother you.	Disculpa la molestia.	
How much would you like?	¿Cuánto quisieras?	
We like it very much.	Nos gusta mucho.	
When will it be ready?	¿Cuándo estará listo?	
How much altogether?	¿Cuánto por todos juntos?	
What do you want to do?	¿Qué quieres hacer?	
"I don't usually do it."	Normalmente no lo hago.	
You speak very well.	Hablas muy bien.	
I have one in my car.	Tengo uno en mi auto.	
"I'm leaving tomorrow."	Me voy mañana.	
How long is the flight?	¿Qué tan largo es el vuelo?	
Where is she going?	¿A dónde va ella?	
Which one is cheaper?	¿Cuál es más barato?	
What do you recommend?	¿Qué me recomienda?	
Are ghosts real?	¿Los fantasmas son reales?	
Why did you say that?	¿Por qué dijiste eso?	
The chair is stable.	La silla es estable.	
Are you ready to leave?	¿Está listo para salir?	
What is the weather like in Beijing?	¿Cómo es el clima en Beijing?.	
Were there any problems?	¿Hubo algún problema?	
The meat is raw.	La carne está cruda.	
They arrived yesterday.	Ellos llegaron ayer.	
What is the area code?	¿Cuál es el código de área?	
What are you thinking about?	¿Qué estás pensando?	
I need another key.	Necesito otra llave.	
When is the next bus?	¿Cuándo viene el próximo autobús?	
She seems tough.	Ella parece dura.	
Is this a safe area?	¿Esta área es segura?	
Are you feeling okay?	¿Te sientes bien?	
"No, I'm not."	No, no me siento bien.	
Do you have any money?	¿Tienes algo de dinero?	
Is your friend Chinese?	¿Tu amigo es chino?	
Yes, he is.	Sí, es chino.	
I came with my family.	Vengo con mi familia.	
Table for two, please.	Mesa para dos, por favor.	
This bag is light.	Esta bolsa es ligera.	
"I don't have any money."	No tengo nada de dinero.	
Are you mad at me?	¿Está enojado conmigo?	
What is the meaning of life?	¿Cuál es el significado de la vida?.	
Does she love him?	¿Ella lo ama?	
Does he tutor?	¿Él da clases particulares?	
Do you have any children?	¿Tienes hijos?	
Can you be more specific?	¿Puede ser mas específico?	
My birthday is today.	Mi cumpleaños es hoy.	
He lost his phone.	Él perdió su teléfono.	
"You don't have to be sorry."	No tiene que estar arrepentido.	
"Lilly doesn't have a boyfriend."	Lily no tiene novio.	
I want to buy something.	Quiero comprar algo.	
Will you take me home?	¿Me llevarías a casa?	
He is a strange man.	Él es un hombre extraño.	
"What's the phone number?"	¿Cuál es el número telefónico?	
Go straight ahead.	Sigue derecho.	
"Here's your bag."	Aquí está tu bolsa.	
"They're very busy."	Están muy ocupados.	
You need to know the truth.	Usted necesita saber la verdad.	
"There's plenty of time."	Hay mucho tiempo.	
I got in an accident.	Me lo hice en un accidente.	
Where did you put it?	¿Dónde lo pusiste?	
Good evening sir.	Buenas noches señor.	
"Why aren't you going?"	¿Por qué no vas a ir?	
Where are we headed?	¿Hacia a dónde nos dirigimos?	
"What's the name of the company?"	¿Cuál es el nombre de la compañía?	
"I think it's very good."	Creo que está muy bien.	
"What's in the suitcase?"	¿Qué hay en el portafolios?	
"I've already seen it."	Ya lo he visto.	
She is a short person.	Ella es una persona baja.	
Where is it?	¿Dónde está?	
At the bus stop.	En la parada de autobuses.	
Are you single?	¿Eres soltera?	
"No, I'm married."	No, estoy casado.	
Are you okay?	¿Estás bien?	
"Yes, I'm fine."	Sí, estoy bien.	
Are you married?	¿Estás casada?	
No, I am single.	No, soy soltero.	
Am I early?	¿Llegué temprano?	
"No, you're late."	No, llegas tarde.	
Are you a doctor?	¿Eres doctor?	
"No, I'm a teacher."	No, soy maestro.	
Where is she from?	¿De dónde es ella?	
"She's from Australia."	Ella es de Australia.	
Did they win?	¿Ellos ganaron?	
Yes, they won.	Sí, ellos ganaron.	
One ticket please.	Un boleto por favor.	
How do I get there?	¿Cómo llego ahí?	
Why did you do that?	¿Por qué hiciste eso?	
How tall are you?	¿Qué tan alto es usted?	
What does this mean?	¿Qué significa esto?	
I wish I had one.	Me gustaría tener uno.	
Thank you very much.	Muchas gracias.	
Which one do you want?	¿Cuál quieres?	
"I'd like a room."	Quisiera un cuarto.	
"It's not too far."	No está muy lejos.	
A one way ticket.	Boleto de ida.	
Will you marry me?	¿Se casaría conmigo?	
"How's the weather?"	¿Cómo está el clima?	
What should I wear?	¿Qué debería ponerme?	
Who are you waiting for?	¿A quién estás esperando?	
We are the same age.	Somos de la misma edad.	
I lost my watch.	Perdí mi reloj.	
"You're very smart."	Eres muy listo.	
That smells bad.	Eso huele mal.	
Do you like to dance?	¿Te gusta bailar?	
"It's far from here."	Está lejos de aquí.	
Can it be cheaper?	¿Puede ser más barato?	
Give me the pen.	Dame la pluma.	
Is it far from here?	¿Está lejos de aquí?	
Can you assist me?	¿Me puedes ayudar?	
The food was delicious.	La comida estaba deliciosa.	
Who won the race?	¿Quién ganó la carrera?.	
Do you have a girlfriend?	¿Tienes novia?	
How tall are you?	¿Cuánto mides?	
He has a new car.	Él tiene un coche nuevo.	
How are your parents?	¿Cómo están tus papás?	
Have a nice trip!	¡Buen viaje!	
Are you waiting for her?	¿Estás esperándola?	
Are you free tonight?	¿Estás libre esta noche?	
As soon as possible.	Lo más pronto posible.	
Is it cold outside?	¿Hace frío afuera?	
Einstein was a brilliant man.	Einstein fue un hombre brillante.	
Is it cold outside?	¿Hace frío afuera?	
"I'm not tired."	No estoy cansado.	
What did you think?	¿Qué pensabas?	
Can you swim?	¿Puedes nadar?	
"What's the temperature?"	¿Cuál es la temperatura?	
"It's too late."	Es demasiado tarde.	
Where is the bathroom?	¿En dónde está el baño?	
I need a doctor.	Necesito un doctor.	
Where do you work?	¿Dónde trabajas?	
This is very important.	Esto es muy importante.	
Thank you sir.	Gracias señor.	
I speak a little.	Hablo un poco.	
"Who's calling?"	¿Quién llama?	
"That's not fair."	Eso no es justo.	
On the second floor.	En el segundo piso.	
"Don't be nervous."	No se ponga nervioso.	
How about Saturday?	¿Qué tal el sábado?	
"I'm not hungry."	No tengo hambre.	
The United States has fifty states.	Estados Unidos tiene cincuenta estados.	
What is the video about?	¿De qué trata el video?.	
Is the train coming?	¿Sí viene el tren?	
Did she hear?	¿Ella escuchó?	
Take this medicine.	Toma esta medicina.	
Nothing is impossible.	Nada es imposible.	
I like volleyball.	Me gusta el volleyball.	
Let me check.	Déjame revisarlo.	
"He's in the kitchen."	Él está en la cocina.	
Do you like the book?	¿Te gusta el libro?	
"Don't be silly."	No seas tonto	
I have a headache.	Me duele la cabeza.	
Can I try it on?	¿Puedo probármelo?	
"I can't hear you."	No te escucho.	
Nice to meet you	Encantado de conocerte.	
Give me a call.	Llámame.	
When are you moving?	¿Cuándo te mudas?	
I have a reservation.	Tengo una reservación.	
When are you leaving?	¿Cuándo te vas?	
Do you have a problem?	¿Tienes algún problema?	
Have a good trip.	Ten un buen viaje.	
"That's too bad."	Eso está muy mal.	
"It's really hot."	Está muy caliente.	
I made a mistake.	Cometí un error.	
"What's your name?"	¿Cómo te llamas?	
"I'm Jeff."	Soy Jeff.	
"What's your name?"	¿Cuál es tu nombre?	
"She's asleep."	Ella está dormida.	
Who taught you that?	¿Quién te enseñó eso?	
"How's business?"	¿Cómo va el negocio?	
What do you study?	¿Qué estudias?	
"I don't feel well."	No me siento bien.	
Where did you go?	¿A dónde fuiste?	
The ball is round.	La pelota es redonda.	
Please be patient.	Por favor sea paciente.	
"You're very nice."	Eres muy agradable.	
"It's north of here."	Está al norte de aquí.	
"That's a good school."	Esa es una buena escuela.	
Are you sure about that?	¿Está usted seguro de eso?	
When are they coming?	¿Cuándo van a venir?	
The car is fixed.	El coche está arreglado.	
Where did it go?	¿A dónde se fue?	
"I'm not sure."	No estoy seguro.	
I work in a hospital.	Trabajo en un hospital.	
I need to go now.	Necesito irme ahora.	
She has a career.	Ella tiene una carrera.	
This is very difficult.	Esto es muy difícil.	
The meeting was online.	La reunión fue en línea.	
Can you fix this?	¿Puedes arreglar esto?	
It hurts here.	Duele aquí.	
"I'm going to leave."	Yo me voy a ir.	
Your French is good.	Tu francés es bueno.	
"Who's that woman?"	¿Quién es esa mujer?	
She is my grandmother.	Ella es mi abuela.	
Where do you live?	¿Dónde vives?	
The TV is broken.	La televisión está rota.	
"I'll teach you."	Te enseño.	
Do you like it here?	¿Te gusta aquí?	
No, this is the first time.	No, esta es la primera vez.	
"What's your job?"	¿En qué trabajas?	
"I'm a teacher."	Soy maestro.	
"What's your job?"	¿En qué trabajas?	
"I'm a nurse."	Soy enfermero.	
Do you need anything?	¿Necesitas algo?	
Are you here alone?	¿Estás aquí solo?	
That would be wonderful.	Eso sería maravilloso.	
Who are you looking for?	¿A quién estás buscando?	
"I haven't been there."	Nunca he estado ahí.	
Take me to the hotel.	Llévame al hotel.	
What does this say?	¿Qué dice esto?	
Are your children with you?	¿Están tus hijos contigo?	
A long time ago.	Hace mucho tiempo.	
"Here's my number."	Aquí está mi número.	
Are these your children?	¿Estos son tus hijos?	
Yes, they are.	Sí, son mis hijos.	
The movie was okay.	La película estuvo okay.	
Was the information useful?	¿La información fue útil?	
I ate already.	Yo ya comí.	
I regret nothing.	Yo no me arrepiento de nada.	
The solution is simple.	La solución es simple.	
Do you feel better?	¿Te sientes mejor?	
Thanks for your help.	Gracias por tu ayuda.	
Is he tutoring?	¿Él está dando clases particulares?	
Are you working today?	¿Vas a trabajar hoy?	
"I'm a beginner."	Soy principiante.	
The church is massive.	La iglesia es masiva.	
We go to the movies.	Nosotros vamos al cine.	
McDonalds is a global business.	McDonalds es un negocio global.	
Are you proud of me?	¿Está orgulloso de mí?	
"I'm just kidding."	Estoy bromeando.	
Are you an engineer?	¿Eres ingeniero?	
Yes, I am.	Sí lo soy.	
The sky is blue.	El cielo es azul.	
Jacquie is reading a book.	Jacquie está leyendo un libro.	
How do you say it?	¿Cómo lo dices?	
"I'm going to bed."	Me voy a la cama.	
Who is her husband?	¿Quién es su esposo?	
"I'm here on business."	Vengo aquí por negocios.	
How are your parents?	¿Cómo están tus padres?	
"They're doing great."	Están muy bien.	
What are you going to have?	¿Qué vas a querer?	
How are you paying?	¿Cómo vas a pagar?	
"Here's your order."	Aquí está tu orden.	
Is your father home?	¿Tu padre está en casa?	
When is your birthday?	¿Cuándo es tu cumpleaños?	
Are you related to him?	¿Usted está relacionado con él?	
Whose book is that?	¿De quién es ese libro?	
Please wait for me.	Por favor espérame.	
What is he looking at?	¿Qué está mirando?	
"I'm worried too."	También estoy preocupado.	
When will he be back?	¿Cuándo va a regresar?	
When do we leave?	¿Cuándo nos vamos?	
Who was your teacher?	¿Quién era tu maestro?	
What do they study?	¿Qué estudian ellos?	
How are your parents?	¿Cómo están tus padres?	
"I'm from around here."	Soy de por aquí.	
How do I use this?	¿Cómo utilizo esto?	
The ground is dirty.	El suelo está sucio.	
I need to go home.	Necesito ir a casa.	
Take me downtown.	Llévame al centro.	
Do you have another one?	¿Tienes otro?	