"Don't drag your suitcase on the floor. It will get dirty."	No arrastre su maleta por el piso. Se ensuciará.	
If you want to contact the president, maybe you can send him a letter.	Si desea contactarse con el presidente, tal vez pueda enviarle una carta.	
The bank lended him the money to start a new business.	El banco le prestó el dinero para comenzar un nuevo negocio.	
Did you text Inés for her birthday? -- Yes, I was able to text Inés.	¿Le escribiste a Inés por su cumpleaños? -- Si, pude enviarle un mensaje.	
Be sure to keep a wide stance while playing tennis.	Asegúrese de mantener una postura amplia mientras juega al tenis.	
The professor taught a lot of material, but not all of it was relevant.	El profesor enseñó mucho material, pero no todo era relevante.	
When I drive through the valley, my radio loses signal.	Cuando manejo a través del valle, mi radio pierde señal.	
He goes everywhere by bus because his motorcycle broke.	Él va a todos lados en autobús porque se descompuso su motocicleta.	
"The magician's trick was bad. I knew how he did it."	El truco del mago fue malo. Yo sabía cómo lo hizo.	
"Elyse's in Las Vegas. She's been there for seven (7) months."	Elyse está en Las Vegas. Está ahí desde hace siete (7) meses.	
"They've bought a new truck. They bought a new truck."	Ellos han comprado un nuevo camión. Ellos compraron un nuevo camión.	
Can you explain why glue does not stick to the bottle?	¿Puede explicar por qué el pegamento no se adhiere a la botella?	
I am wearing a warm jacket because it is snowing.	Estoy usando una chaqueta abrigada porque está nevando.	
It snowed all afternoon yesterday. It continued through the night.	Nevó toda la tarde ayer. Continuó durante la noche.	
After you pause the song, you can resume it again whenever.	Después de que pause la canción, puede reanudarla cuando sea.	
I looked for my parents for an hour but I could not find them.	Busqué a mis padres durante una hora pero no pude encontrarlos.	
Does she like to study? -- Yes, she strives for perfection.	¿A ella le gusta estudiar? -- Sí, ella busca la perfección.	
"The university's administration lowered tuition for all their students."	La administración de la universidad bajó el costo de matrícula para todos sus estudiantes.	
After lifting weights for a year, my strength has increased.	Después de levantar pesas durante un año, mi fuerza ha aumentado.	
I went to the supermarket to buy my mother a card for Christmas.	Fui al supermercado a comprarle a mi madre una tarjeta para Navidad.	
I spend a lot of money at that bookstore every time I go.	Gasto mucho dinero en esa librería cada vez que voy.	
The chef used a sharp knife to slice the onion.	El chef usó un cuchillo afilado para cortar la cebolla.	
The homemade ice cream has no artificial flavors.	El helado casero no tiene sabores artificiales.	
"I feel alright today, but I didn't sleep much last night."	Me siento bien hoy, pero no dormí mucho anoche.	
"Have you met Tyrone? -- Yes, we've met once before."	¿Conoces a Tyrone? -- Sí, lo conocí una vez.	
"Check out my new skirt. -- It's beautiful, have you tried it on?"	Mira mi nueva falda. -- Está bonita ¿Ya te la probaste?	
After crashing his car, James went to a mechanic to fix it.	Después de chocar su automóvil, James fue a un mecánico para repararlo.	
"Under the coach's leadership, the soccer team won the match."	Bajo el liderazgo del entrenador, el equipo de fútbol ganó el partido.	
She makes an occasional mistake, but otherwise she is perfect.	Ella comete un error ocasional, pero por lo demás es perfecta.	
The teacher allowed her students to chew gum in class.	La maestra permitió que sus alumnos masticaran chicle en clase.	
My teacher assigned a group project that is due next week.	Mi maestra asignó un proyecto grupal que debe entregarse la próxima semana.	
I hate my commute, especially when there is a lot of traffic.	Odio mi viaje diario, especialmente cuando hay mucho tráfico.	
The doctor performed an experimental procedure on a rare disease.	El doctor realizó un procedimiento experimental en una enfermedad rara.	
"She can't login to her email. She forgot the password."	Ella no puede entrar a su email. Olvidó su contraseña.	
At four-twenty (4:20), he was eating sprouted almonds.	A las cuatro veinte (4:20), él estaba comiendo almendras germinadas.	
Even though George is tall, he could not reach the top shelf.	Aunque George es alto no pudo alcanzar el estante superior.	
The movie was not appropriate for children because it had lots of violence.	La película no era apropiada para niños porque tenía mucha violencia.	
Your suitcase is enormous. How did it fit in your car?	Su maleta es enorme. ¿Cómo entraba en su auto?	
The non-profit organization helps people speak languages better.	La organización sin fines de lucro ayuda a las personas a hablar mejor los idiomas.	
Can you estimate the number of jelly beans in this jar?	¿Puede estimar el número de gomitas en este frasco?	
I just ran five (5) miles and I feel like a million bucks.	Acabo de correr cinco (5) millas y me siento espectacular.	
Learning a new language gives me an advantage while travelling.	Aprender un nuevo idioma me da una ventaja al viajar.	
How fast was she going when she was cycling down the hill?	¿Qué tan rápido iba ella en la bicicleta cuando bajaba la colina?	
Is there a biological explanation for why giraffes are tall?	¿Hay una explicación biológica del por qué las jirafas son altas?	
What is the best way to divide a cake into seven pieces?	¿Cuál es la mejor manera de dividir un pastel en siete pedazos?	
Even though he grew up poor, he is now very wealthy.	Aunque creció pobre, ahora él es muy rico.	
I clicked on the email, but then I realized it was spam.	Hice clic en el correo electrónico pero luego me di cuenta de que era spam.	
"Pat's on vacation in British Columbia. He's coming home on Monday."	Pat está de vacaciones en La Columbia Británica. Regresará a casa el lunes.	
I beat my father in a game of chess for the first time yesterday.	Ayer le gané a mi padre en un juego de ajedrez por primera vez.	
He arrived at work and created three (3) designs for the company website.	Él llegó a su trabajo e hizo tres (3) diseños para el sitio web de la compañía.	
Does the store accept credit cards? No, it is cash only.	¿La tienda acepta tarjetas de crédito? No, solo efectivo.	
The first act of the play was okay, but the second act was amazing.	El primer acto de la obra estuvo bien, pero el segundo acto fue increíble.	
Has he ever played tennis? -- Yes, he plays a lot.	¿Alguna vez ha jugado tenis? -- Sí, juega mucho.	
Yudong is gone on business. Where is he now?	¿Yudong se fue por negocios? ¿Dónde está ahora?	
I receive the paper daily, but sometimes I read other news.	Recibo el periódico a diario, pero a veces leo otras noticias.	
"This jacket isn't very comfortable. Why is it so expensive?"	Esta chamarra no es muy cómoda. ¿Por qué está tan cara?	
He lost his short-term memory from a car accident.	Perdió su memoria a corto plazo en un accidente automovilístico.	
The sun was fairly yellow, and he was feeling mellow.	El sol estaba luminoso y él se sentía meloso.	
My neck is sore after using the computer for so long.	Mi cuello está adolorido después de usar la computadora por tanto tiempo.	
"You've lost your ID. You cannot find your ID."	Perdiste tu identificación. No puedes encontrar tu identificación.	
He scraped his knee outside. -- How did that happen?	Él se raspó la rodilla afuera. -- ¿Cómo sucedió?	
Has he met your sister, or should I suggest they meet?	¿Ya conoció a tu hermana o debería sugerirles que se conozcan?	
"I have a song stuck in my head, but I don't remember the name."	Tengo una canción pegada en mi cabeza, pero no recuerdo el nombre.	
The fifty stars on the American flag represent the fifty states.	Las cincuenta estrellas en la bandera estadounidense representan los cincuenta estados.	
I walk to that park every morning because it is on the way to work.	Camino a ese parque todas las mañanas porque está camino al trabajo.	
"They've bought three (3) new trucks in the last five (5) years."	Ellos compraron tres (3) nuevos camiones en los últimos cinco (5) años.	
"My grandfather's generation grew up without smartphones."	La generación de mi abuelo creció sin smartphones.	
I see an image with three dogs on your screensaver.	Veo una imagen con tres perros en su protector de pantalla.	
We had a good time visiting Asia. We stayed at a hotel in Hong Kong.	La pasamos bien en Asia. Nos quedamos en un hotel en Hong Kong.	
"He's a very loud guy. He likes to talk a lot."	Él habla muy fuerte. Le gusta hablar mucho.	
The price of the plasma TV was reasonable, so we bought it.	El precio de la TV de plasma era razonable, así que la compramos.	
"They live on Market Street. They've only lived there for a few months."	Ellos viven en la calle Market. Viven ahí desde hace pocos meses.	
He was finished with his morning routine and departed for work.	Él terminó su rutina matutina y se fue al trabajo.	
"You've never visited Madagascar, but my sister's visited before."	Tú nunca has visitado Madagascar, pero mi hermana lo ha visitado antes.	
John learned to ride a bike when he was five years old.	John aprendió a manejar bicicleta cuando tenía cinco años.	
We saw wild mushrooms growing in our backyard.	Vimos hongos silvestres creciendo en nuestro patio trasero.	
"She's a great volleyball player, but doesn't usually play."	Ella juega muy bien volleyball, pero usualmente no juega.	
The actual height of the building is taller than I imagined.	La altura real del edificio es más alta de lo que imaginaba.	
"I cannot comment on the issue because I don't know enough about it."	No puedo comentar sobre el tema porque no sé lo suficiente al respecto.	
"Is Zack running around the track? -- No, he's not running."	¿Zack está corriendo por la pista? -- No, no está corriendo.	
He started to feel sick because he lacked vitamins.	Empezó a sentirse enfermo porque carecía de vitaminas.	
My professor started teaching at the college five years ago.	Mi profesor comenzó a enseñar en la universidad cinco años atrás.	
Why did you show up late to work? -- The train was delayed.	¿Por qué llegaste tarde al trabajo? -- El tren se retrasó.	
It is a tough choice, but I will need to move to a new city.	Es una decisión difícil, pero necesitaré mudarme a una nueva ciudad.	
The cause of my financial problems started after I lost my job.	La causa de mis problemas financieros comenzó después de que perdí mi trabajo.	
"He's a vegan. He doesn't consume animal products."	Él es vegano. No consume productos de origen animal.	
Even though she was rejected for the job, she found another one.	A pesar de que fue rechazada en el trabajo, ella encontró otro.	
After seeing the evidence, the jury concluded that he was innocent.	Después de ver la evidencia el jurado concluyó que era inocente.	
The restaurant has terrible service but the food tastes amazing.	El restaurante tiene un servicio terrible pero la comida sabe increíble.	
Breathe in through your nose and blow out of your mouth.	Inhale por la nariz y exhale por la boca.	
Did the student complete her assignment? -- Yes, she completed it.	¿La estudiante terminó su tarea? -- Sí, la terminó.	
"Sally's mother limits the television that she can watch."	La madre de Sally limita la televisión que ella puede ver.	
Why does the licence plate only have five digits?	¿Por qué la matrícula solo tiene cinco dígitos?	
Jack and Jill talked about marriage for many years before they were married.	Jack y Jill hablaron sobre el matrimonio durante muchos años antes de casarse.	
You should skip this section of the book. It will not be on the test.	Debe saltar esta sección del libro. No estará en la prueba.	
If I sit on this chair too long, my back hurts.	Si me siento en esta silla demasiado tiempo, me duele la espalda.	
She bought six light bulbs at the department store.	Ella compró seis bombillas en la tienda departamental.	
Does he walk to work? -- He used to, but now he has a driver.	¿Él camina al trabajo? -- Solía hacerlo, ahora tiene un chofer.	
Has he ever written a love letter? -- Yes, once in college.	¿Alguna vez él ha escrito una carta de amor? -- Sí, una vez en la universidad.	
"Bob did work in the field, but he didn't do work in the farm house."	Bob hizo el trabajo en el campo, pero no hizo el trabajo en la granja.	
The path to success is sometimes lonely but is always worth it.	El camino hacia el éxito a veces es solitario, pero siempre lo vale.	
The recipe tells me to add three eggs to the mixture.	La receta me dice que agregue tres huevos a la mezcla.	
Susan fell down a flight of stairs and broke her leg.	Susan se cayó por unas escaleras y se rompió la pierna.	
Do I need to buy a lot of equipment for mountain climbing?	¿Debo comprar mucho equipo para escalar montañas?.	
At the corner of the street, there are many nice coffee shops.	En la esquina de la calle, hay muchas buenas cafeterías.	
I applied to the job five times before I received an interview.	Apliqué al trabajo cinco veces antes de recibir una entrevista.	
She likes candy. What about them? Do they like candy?	A ella le gustan los dulces. ¿Y a ellos? ¿Les gustan los dulces?	
The review wrote positive things about the language learning app.	La crítica escribió cosas positivas sobre la aplicación de aprendizaje de idiomas.	
"My company's mission is to help people speak languages better."	La misión de mi empresa es ayudar a las personas a hablar mejor los idiomas.	
Last week, he met Don in line at his favorite café.	La semana pasada, él conoció a Don en la fila de su cafetería preferida.	
I appreciate my Spanish teacher for helping me learn a new language.	Agradezco a mi maestra de español por ayudarme a aprender un nuevo idioma.	
The invention of the cell phone has changed the way we communicate.	La invención del teléfono celular ha cambiado la forma en que nos comunicamos.	
"Who is that woman? -- I'm not sure, this is my first time meeting her."	¿Quién es esa mujer? -- No estoy seguro, es la primera vez que la veo.	
I bought my mother the present that she always wanted for Christmas.	Le compré a mi madre el regalo que siempre quiso para Navidad.	
"They've bought a new truck. They have a new truck now."	Ellos compraron un nuevo camión. Ahora tienen un camión nuevo.	
She tries not to depend on her mother for financial support.	Ella trata de no depender de su madre para apoyo financiero.	
"Ask if she has a cat. -- Yes, she's got a cat."	Pregunta si ella tiene un gato. -- Sí, ella tiene un gato.	
"I don't feel any heat. I think my stove is broken."	No siento calor. Creo que mi estufa está rota.	
There are sixty-four squares on a chess board.	Hay sesenta y cuatro cuadrados en un tablero de ajedrez.	
I have several succulent plants in my dorm room.	Tengo varias plantas suculentas en mi dormitorio.	
The local grocery store has a nice selection of vegetables.	La tienda de comestibles local tiene una buena selección de verduras.	
The army put up an excellent defense and the town was saved.	El ejército levantó una defensa excelente y la ciudad fue salvada.	
The school committee decided that they needed to start a new scholarship.	El comité de la escuela decidió que necesitaban comenzar una nueva beca.	
He stood on the edge of the cliff and admired the sunset.	Se paró en el borde del acantilado y admiró la puesta de sol.	
I got up from the seat three times during the scary movie.	Me levanté de mi asiento tres veces durante la película de miedo.	
"I'm sorry, but he is not available. Do you want to leave a message?"	Lo siento, pero él no está disponible. ¿Quiere dejar un mensaje?	
Have they ever gotten into an argument? -- Yes, twice.	¿Alguna vez se han metido en una discusión? -- Si, en dos ocasiones.	
If you do not refrigerate the meat, it will rot.	Si no refrigera la carne, esta se pudrirá.	
By lying on your back, you float on the surface of the water.	Al acostarse boca arriba, usted flota en la superficie del agua.	
That grocery store gives out many free samples.	Esas tiendas de comestibles dan muchas muestras gratis.	
Be careful. Do not cut yourself with the kitchen knife.	Tenga cuidado. No se corte con el cuchillo de cocina.	
He played that game for three hours to reach the next level.	Él jugó ese juego durante tres horas para llegar al siguiente nivel.	
I ran to school this morning because I woke up late.	Corrí a la escuela esta mañana porque me desperté tarde.	
Are the flavors in the ice cream natural or artificial?	¿Los sabores en el helado son naturales o artificiales?	
I live around here. How about Ted? Does he live around here?	Yo vivo por aquí. ¿Y Ted? ¿Él vive por aquí?	
"Ask if she has a son. -- Yes, she's got a son."	Pregunta si ella tiene un hijo. -- Sí, ella tiene un hijo.	
You need a valid email address to create an account.	Usted necesita una dirección de correo electrónico válida para crear una cuenta.	
The police pursued the criminal in a dramatic car chase.	La policía persiguió al criminal en una dramática persecución en auto.	
It is difficult not to be emotional while making important decisions.	Es difícil no ser emocional al tomar decisiones importantes.	
"Isn't it amazing that we can have a phone in our pockets?"	¿No es sorprendente que podamos tener un teléfono en nuestros bolsillos?	
To avoid injury, stretch before lifting weights.	Para evitar lesiones, estire antes de levantar pesas.	
"It's a beautiful apartment, but it doesn't have air conditioning."	Es un hermoso departamento, pero no tiene aire acondicionado.	
Only a few people attended my party, but it was still great.	Solo unas pocas personas asistieron a mi fiesta pero aún así fue genial.	
I cannot do physical tasks because my back hurts.	No puedo hacer tareas físicas porque me duele la espalda.	
"It's half past two (2:30). Lulu is at the park playing."	Son las dos y media (2.30). Lulu está jugando en el parque.	
He was sent to detention at school because of bad behavior.	Él fue enviado a detención en la escuela debido a mal comportamiento.	
At nine-thirty (9:30), he was enjoying a cup of tea.	A las nueve y media (9:30), él disfrutaba de una taza de té.	
Eating a healthy diet lowers your cholesterol.	Comer una dieta saludable reduce su colesterol.	
"At eleven o'clock (11:00), he was at the dentist's office."	A las once (11:00) en punto, él estaba en el consultorio del dentista.	
Remain in your seat with your seatbelt fastened.	Permanezcan en su asiento con el cinturón de seguridad abrochado.	
If the ball does not go over the net, you lose the point.	Si la pelota no pasa la red, pierde el punto.	
Will you be presenting your research at the conference next weekend?	¿Presentará su investigación en la conferencia el próximo fin de semana?	
The wind blew all the car exhaust into my face.	El viento sopló todo el escape del auto en mi cara.	
"It's only eight-thirty (8:30) and Javier is already asleep in bed."	Son apenas las ocho treinta (8:30) y Javier ya esta acostado en su cama.	
Has Zach finished working yet? -- Yes, he should be here soon.	¿Zach ya terminó de trabajar? Sí, debería llegar pronto.	
The movie ended so suddenly. I thought that it would be longer.	La película terminó tan de repente. Pensé que sería más larga.	
Jack and Jill could not reach an agreement, so they kept arguing.	Jack y Jill no pudieron llegar a un acuerdo, así que siguieron discutiendo.	
At higher speeds, my car makes a lot of noise.	A velocidades más altas, mi auto hace mucho ruido.	
I like to drink a moderate amount of coffee every morning.	Me gusta beber una cantidad moderada de café todas las mañanas.	
"They know Lulu. They've known her for a few years."	Ellos conocen a Lulu. La conocen desde hace varios años.	
Can you examine my car? I see smoke coming out of it.	¿Puede examinar mi auto? Veo humo saliendo.	
Your socks are cool. Did they cost a lot of money?	Tus calcetines están geniales. ¿Te costaron mucho dinero?	
"Ask if she has eggs. -- No, she doesn't have eggs."	Pregunta si ella tiene huevos. -- No, no tiene huevos.	
The dentist saw a cavity in his upper tooth.	El dentista vio una cavidad en su diente superior.	
My mother likes to bake apple pie.	A mi madre le gusta hornear tarta de manzana.	
If you could travel anywhere in the world, where would you go?	Si pudiera viajar a cualquier parte del mundo, ¿a dónde iría?	
He tries to quit smoking every few months.	Él trata de dejar de fumar cada pocos meses.	
Some like to hunt wild animals as a hobby.	A algunos les gusta cazar animales salvajes como un hobby.	
The hostel was in a good location, and it was cheap too.	El hostal tenía una buena ubicación, y estaba barato también.	
His car is very clean. He cleans it often.	Su coche está muy limpio. Él lo lava seguido.	
It was cold in the kitchen, so I turned on the heater.	Hacía frío en la cocina, así que encendí la calefacción.	
"Everyone loves her. She's got loads of friends."	Todos la aman. Ella tiene muchos amigos.	
I have a lot of stuff in my room that I need to clean.	Tengo muchas cosas en mi habitación que necesito limpiar.	
"My battery won't charge. I will need to replace it."	Mi batería no carga. Tendré que reemplazarla.	
Should I drink eight glasses of water every day?	¿Debo tomar ocho vasos de agua todos los días?	
Can you speak a little louder? I cannot hear you.	¿Puede hablar un poco más fuerte? No puedo escucharlo.	
What does your father do?	¿A qué se dedica tu papá?	
"He's an author. He's won many prizes for his work."	Él es autor. Ha ganado muchos premios por su trabajo.	
How was the weather?	¿Cómo estuvo el clima?	
The sun was shining. It was twenty-three degrees (23˚C).	El sol estaba radiante. La temperatura estaba a veintitres grados (23˚C).	
Have you read this article? -- No, but I plan on reading it.	¿Has leído este artículo? -- No, pero planeo leerlo.	
A piece of gum costs eighty cents.	Un chicle cuesta ochenta centavos.	
When I was younger, I only liked chocolate milk.	Cuando era más joven, sólo me gustaba la leche con chocolate.	
"I cannot reach the top shelf because I'm short."	No puedo llegar al estante superior porque soy bajo.	
The weather is great today, but yesterday it was stormy.	El clima está genial hoy, pero ayer estaba tempestuoso.	
"The weather's sunny today. It's not raining."	Está soleado hoy. No está lloviendo.	
I warmed my room by turning on the heater.	Calenté mi habitación encendiendo el calentador.	
I still have to brush my teeth and take a shower.	Todavía tengo que lavarme los dientes y bañarme.	
The teacher urged her students to think about their future.	La maestra instó a sus alumnos a pensar sobre su futuro.	
Welcome to my house. Please make yourself feel at home.	Bienvenido a mi casa. Por favor, siéntase en casa.	
"He's been studying Cantonese for three (3) years now."	Él ha estudiado Cantonés durante los últimos tres años.	
"What's Jennifer like? Is she beautiful? -- I don't know her very well."	¿Cómo es Jennifer? ¿Es bonita? -- No la conozco muy bien.	
The jar contains thousands of jelly beans.	El frasco contiene miles de caramelos de goma.	
Do you consider the tomato a fruit or a vegetable?	¿Considera que el tomate es una fruta o un vegetal?	
Everybody I met at the party had something interesting to say.	Todos los que conocí en la fiesta tuvieron algo interesante que decir.	
"We went to the mall, but we didn't go to the supermarket."	Fuimos al centro comercial, pero no fuimos al supermercado.	
In order to become a lawyer, you need many years of education.	Para convertirse en abogado necesita muchos años de educación.	
She speaks five (5) languages, but none of them well.	Ella habla cinco (5) idiomas, pero ninguno bien.	
After I saw that she was crying, I comforted her.	Después de ver que ella estaba llorando, la consolé.	
How many apples do you see on the apple tree?	¿Cuántas manzanas ves en el árbol de manzana?.	
I used a wooden spoon to stir the pot.	Usé una cuchara de madera para revolver la olla.	
He purchased his airline tickets with an app.	Él compró sus boletos de avión con una aplicación.	
How was she feeling last week? -- She was feeling better.	¿Cómo se sentía ella la semana pasada? -- Se sentía mejor.	
What makes keeping a budget so difficult for most people?	¿Qué hace que mantener un presupuesto sea tan difícil para la mayoría de las personas?	
There are so many people in the gym at the start of the new year.	Hay tantas personas en el gimnasio al comienzo del año nuevo.	
The actors performed a play in front of a large audience.	Los actores representaron una obra frente a una gran audiencia.	
The coach of the basketball team led his team to victory.	El entrenador del equipo de baloncesto llevó a su equipo a la victoria.	
A private lesson costs more than a group lesson.	Una clase privada cuesta más que una clase grupal.	
Where was he at two p.m. (2:00) last Thursday afternoon?	¿Dónde estaba él, el jueves pasado a las dos (2:00) de la tarde?	
I am willing to share my french fries with you.	Estoy dispuesto a compartir mis papas fritas con usted.	
He stopped skating and entered the basketball gym.	El dejó de patinar para entrar al gimnasio de basquetbol.	
I think I did well on the interview. Hopefully, I get the job.	Creo que lo hice bien en la entrevista. Con suerte, obtengo el trabajo.	
She speaks Chinese. How about her father? Does he speak Chinese?	Ella habla chino. ¿Y su papá? ¿Él habla chino?	
"The hostel is inexpensive. It's cheap to stay there."	El hostal es barato. Es barato quedarse ahí.	
At a quarter before seven (6:45), he was cleaning the dishes.	Al cuarto para las siete (6:45), él estaba lavando los platos.	
When was the last time you went to the cinema? -- Just last night.	¿Cuándo fue la última vez que fuiste al cine? -- Anoche.	
"It's a beautiful apartment, but it doesn't have enough windows."	Es un hermoso departamento, pero no tiene suficientes ventanas.	
The division sign is a line in the middle of two dots.	El signo de división es una línea en el medio de dos puntos.	
"He's been watching videos since eight o'clock (8:00)."	Él ha estado viendo videos desde las ocho (8:00).	
Please raise your hand if you want to ask a question.	Por favor levante la mano si quiere hacer una pregunta.	
Even though it was not her fault, they blamed her.	Aunque no fue su culpa, la culparon.	
He will get his monthly paycheck next Thursday.	Él recibirá su cheque mensual el próximo jueves.	
My brain is tired after a long day of hard work.	Mi cerebro está cansado después de un largo día de duro trabajo.	
They love animals. They have one (1) dog and three (3) cats.	Ellos aman a los animales. Tienen un (1) perro y tres (3) gatos.	
The entire school showed up during the graduation ceremony.	Toda la escuela se hizo presente durante la ceremonia de graduación.	
The editor of the newspaper seems very happy with her job.	El editor del periódico parece muy feliz con su trabajo.	
There is a lot of pressure for me to pass the test tomorrow.	Hay mucha presión para que yo pase la prueba mañana.	
I have a very interesting brother and he is really smart too.	Tengo un hermano muy interesante y él también es muy inteligente.	
After eating a lot of sugar, I felt restless.	Después de comer mucha azúcar, me sentí inquieto.	
"Sofia and Anthony are a couple. They've been married for twelve (12) years."	Sofia y Anthony son pareja. Ellos han estado casados por doce (12) años.	
Do not operate machinery after taking this pill.	No opere maquinaria después de tomar esta pastilla.	
I started my new diet last week, and I feel great.	Comencé mi nueva dieta la semana pasada, y me siento genial.	
I usually eat a plain bagel for breakfast.	Usualmente me como una simple rosquilla en el desayuno.	
I visited my grandparents during my summer vacation.	Visité a mis abuelos durante mis vacaciones de verano.	
The painter blended the red and orange paints.	El pintor mezcló las pinturas roja y naranja.	
After losing his apartment, he was temporarily homeless.	Después de perder su departamento, estuvo temporalmente sin hogar.	
I hired an accountant to help me with my taxes.	Contraté a un contador para que me ayudara con mis impuestos.	
No, but they won recently in two-thousand fourteen (2014).	No, pero ganaron recientemente en el dos mil catorce (2014).	
The thought of him winning the presidential election was unbearable.	El pensamiento de que él ganara las elecciones presidenciales era insoportable.	
Do you know how to spin a basketball on your finger?	¿Sabes cómo hacer girar una pelota de baloncesto en tu dedo?	
He often runs around the track, and does so very well.	Él frecuentemente corre por la pista, y lo hace muy bien.	
"I had trouble keeping up with the teacher's lecture."	Tuve problemas para seguir la conferencia del profesor.	
When was the last time she went to the bank? -- Two (2) years ago.	¿Cuándo fue la última vez que ella fue al banco? -- Hace dos (2) años.	
There are no available tables at this restaurant right now.	En este momento no hay mesas disponibles en este restaurante.	
"They've already done a lot of planning for their marriage."	Ya han hecho muchos planes para su boda.	
"Does Paulo know that you're leaving? -- Yes, I told him already."	¿Paulo sabe que ya te vas? -- Sí, ya le dije.	
If I did not have health insurance, I would be bankrupt.	Si no tuviera seguro de salud, estaría en bancarrota.	
I would encourage you to read a book in your spare time.	Lo animaría a que lea un libro en su tiempo libre.	
This version of the app has more features than ever before.	Esta versión de la aplicación tiene más funciones que nunca.	
I told my boss that I was going to quit my job.	Le dije a mi jefe que iba a renunciar a mi trabajo.	
I would like to emphasize the importance of investing your money.	Me gustaría enfatizar la importancia de invertir su dinero.	
It takes a lot of manual labor to build a house.	Se necesita mucho trabajo manual para construir una casa.	
You can wear casual attire to the barbeque.	Puede usar vestimenta casual para la barbacoa.	
She was jogging around the track, not listening to music.	Ella estaba corriendo alrededor de la pista, no estaba escuchando música.	
Sometimes I feel like my uncle argues too much.	A veces siento que mi tío discute demasiado.	
He wanted my attention, so he tapped my shoulder.	Él quería mi atención, así que me tocó el hombro.	
"We've known Dan since nineteen ninety-seven (1997)."	Nosotros conocemos a Dan desde mil novecientos noventa y siete (1997).	
"It wasn't raining, so we walked around the neighborhood."	No estaba lloviendo, así que caminamos por el vecindario.	
Please wear solid colors only. No stripes.	Por favor, use colores sólidos únicamente. Sin rayas.	
What happens if an earthquake occurs? Are you prepared?	¿Qué pasa si ocurre un terremoto? ¿Está preparado?	
My mother has blue eyes but I have brown eyes.	Mi madre tiene ojos azules pero yo tengo ojos marrones.	
Even though it seems crazy, I think the plan could work.	Aunque parece una locura, creo que el plan podría funcionar.	
In order to survive on the island, you must learn to fish.	Para sobrevivir en la isla, debe aprender a pescar.	
The amount of famous art in the museum is astounding to me.	La cantidad de arte famoso en el museo me resulta asombrosa.	
"My phone's screen cracked when I dropped it."	La pantalla de mi teléfono se rajó cuando lo dejé caer.	
He is regarded as one of the best poets of our generation.	Él es considerado como uno de los mejores poetas de nuestra generación.	
Gustave has taken my pencil without asking.	Gustave tomó mi lápiz sin preguntar.	
What did you do last weekend? I relaxed at the beach.	¿Qué hizo el fin de semana? Me relajé en la playa.	
"You don't need to text them. You sent them a voicemail."	No necesitas enviarles un mensaje de texto. Les enviaste un correo de voz.	
My brother acted strange at the party last weekend.	Mi hermano actuó extraño en la fiesta el fin de semana pasado.	
Everyone was confused about his sudden leave of absence.	Todos estaban confundidos acerca de su repentina excedencia.	
I wish that this country would not fight so many wars.	Deseo que este país no pelee tantas guerras.	
The most obvious thing to do might not be the best thing to do.	La cosa más obvia por hacer podría no ser la mejor cosa por hacer.	
The chef split the pizza into eight slices.	El chef dividió la pizza en ocho porciones.	
The diamonds are very expensive. They cost a lot of money.	Los diamantes son muy caros. Cuestan mucho dinero.	
"He owns a motorcycle, but doesn't usually ride it."	Él tiene una motocicleta, pero normalmente no la usa.	
After I started wearing glasses, my vision improved.	Después de que comencé a usar lentes, mi visión mejoró.	
"She drinks coffee, but she doesn't drink tea."	Ella toma café, pero no toma té.	
"Is the email legitimate? I'm worried that it is a scam."	¿Es el correo electrónico legítimo? Me preocupa que sea una estafa.	
I had to transfer planes twice during my trip to Shanghai.	Tuve que transbordar de avión dos veces durante mi viaje a Shanghai.	
There are very few affordable apartments left in the city.	Quedan muy pocos apartamentos asequibles en la ciudad.	
The star athlete stepped onto the basketball court.	El atleta estrella entró en la cancha de baloncesto.	
My professor tested me on his lectures last week.	Mi profesor me evaluó en sus conferencias la semana pasada.	
I need to take this call because my mother is in an emergency.	Necesito tomar esta llamada porque mi madre está en una emergencia.	
"She's feeling sick. She has a sore throat."	Ella se siente mal. Le duele la garganta.	
"What did she say? -- I'm not sure, I couldn't hear her."	¿Qué dijo ella? -- No estoy seguro, no pude escucharla bien.	
"Where are the kids? -- I'm not sure, they were here when I left."	¿Dónde están los niños? -- No estoy seguro, estaban aquí cuando me fui.	
I am going to make you an offer that you cannot refuse.	Voy a hacerle una oferta que no puede rechazar.	
After weeks of not eating, he was desperate to find food.	Después de semanas sin comer, él estaba desesperado por encontrar comida.	
John has a lack of attention because of his medical condition.	John tiene una falta de atención debido a su condición médica.	
My dog looks hungry. I need to feed him now.	Mi perro parece hambriento. Necesito alimentarlo ahora.	
Did her children have a good time in California? -- Yes, they did.	¿Sus hijos la pasaron bien en California? -- Sí, la pasaron bien.	
I earned a degree in computer science from a great university.	Obtuve un título en informática de una gran universidad.	
There is a large seed at the center of every avocado.	En el centro de todo aguacate hay una gran semilla.	
"It's calm this evening, but it was stormy all day."	La noche está tranquila, pero estuvo tempestuoso todo el día.	
"I bought fresh strawberries at the farmer's market."	Compré fresas frescas en el mercado de agricultores.	
The sleeping pill will ensure that you fall asleep.	La pastilla para dormir asegurará que se duerma.	
I have to read fifty pages from the book for homework.	Tengo que leer cincuenta páginas del libro para la tarea.	
"There's a restaurant over there, but I don't think it's very good."	Hay un restaurante por allá, pero no creo que sea muy bueno.	
I threw the raw pasta into the boiling water.	Tiré la pasta cruda en el agua hirviendo.	
I always lock my front door when I leave the house.	Siempre cierro la puerta de mi casa cuando salgo de la casa.	
I grabbed three boxes of cereal from the shelf.	Agarré tres cajas de cereal del estante.	