I need to update my website.	Necesito actualizar mi sitio web.	
The weather was terrible yesterday.	El clima estaba terrible ayer.	
Where can I rent a car?	¿Dónde puedo rentar un auto?	
He never watches videos.	Él nunca ve videos.	
The waiter at the French restaurant was French.	El camarero en el restaurante francés era francés.	
My wife told me to do it.	Mi esposa me dijo que lo hiciera.	
What time does the movie start?	¿A que hora empieza la pelicula?	
The numbers are completely random.	Los números son completamente aleatorios.	
Kendrick has been in New York for five (5) weeks.	Kendrick ha estado en Nueva York por cinco (5) semanas.	
January is the first month of the year.	Enero es el primer mes del año.	
The neighborhood is safe for children.	El barrio es seguro para los niños.	
"It's more dangerous these days."	Es mucho más peligroso en estos días.	
John is going on vacation tomorrow.	John se va de vacaciones mañana.	
One way or round trip?	¿Boleto de ida o redondo?	
How long have you worked here?	¿Cuánto tiempo llevas trabajando aquí?	
How do you handle stress?	¿Cómo maneja usted el estrés?	
How much do I owe you?	¿Cuánto te debo?	
When does the plane arrive?	¿A qué hora llega el avión?	
They are a peaceful tribe.	Ellos son una tribu pacífica.	
How do you define success?	¿Cómo define usted el éxito?	
"I'll call you when I leave."	Te llamo cuando me vaya.	
The grocery store is near.	El supermercado está cerca.	
Her father is recently single.	Su padre está recientemente soltero.	
The sea is full of dolphins.	El mar está lleno de delfines.	
How long will you be staying?	¿Por cuánto tiempo te quedas?	
"I'm not sitting on a chair."	No estoy sentado en una silla.	
What kind of music do you like?	¿Qué tipo de música le gusta?	
The couple posed for the picture.	La pareja posó para la foto.	
The bear climbed the tree.	El oso trepó al árbol.	
The library is completely silent.	La biblioteca está completamente en silencio.	
"What's the charge per night?"	¿Cuánto es el costo por noche?	
"What's your email address?"	¿Cuál es tu dirección de correo electrónico?	
My toothbrush is automatic.	Mi cepillo de dientes es automático.	
What a beautiful home! I love it.	¡Qué hermosa casa! Me encanta.	
What time did you wake up?	¿A qué hora te despertaste?	
"He's been to Germany twice."	Él ha estado en Alemania dos veces.	
Did you do research at the university?	¿Usted hizo investigación en la universidad?	
Am I being too harsh?	¿Estoy siendo muy duro?	
"He's been to Portugal once."	Él ha estado en Portugal una vez.	
Do you take credit cards?	¿Aceptas tarjetas de crédito?	
Are you willing to risk it all?	¿Está dispuesto a arriesgarlo todo?	
I cleaned the bathroom already.	Yo ya limpié el baño.	
Who was your previous employer?	¿Quién fue su empleador anterior?	
Are your children watching TV?	¿Tus hijos están viendo la televisión?	
"He's not wearing a hat."	Él no está usando un sombrero.	
"She doesn't have any sisters."	Ella no tiene ninguna hermana.	
Where can I exchange currency?	¿Dónde puedo cambiar mi dinero?	
My watch has been stolen.	Mi reloj ha sido robado.	
"He's lying on the couch."	Él está acostado en el sillón.	
Are you enjoying the book?	¿Te está gustando el libro?	
"It's very funny, but no."	Es muy gracioso, pero no.	
How old are your children?	¿Qué edad tienen tus hijos?	
Four (4), nine (9), and thirteen (13).	Cuatro (4), nueve (9), y trece (13).	
Where are you from?	¿De dónde eres?	
"I'm from Los Angeles."	Soy de Los Ángeles.	
What kind of music do you like?	¿Qué tipo de música te gusta?	
Are you hungry?	¿Tienes hambre?	
"No, but I'm thirsty."	No, pero tengo sed.	
How old are you?	¿Cuántos años tienes?	
"I'm thirty (30) years old."	Tengo treinta (30) años.	
His family is coming tomorrow.	Su familia vendrá mañana.	
"It isn't sunny today."	Hoy no está soleado.	
Does it snow in the winter?	¿Nieva en el invierno?	
It is a matter of life and death.	Es una cuestión de vida o muerte.	
This pond is shallow.	Este estanque es poco profundo.	
These pants are tight.	Estos pantalones son ajustados.	
"He's not playing the piano."	Él no está tocando el piano.	
Physics is an interesting subject to me.	La física es un tema interesante para mí.	
You are energetic this morning!	¡Tienes mucha energía esta mañana!	
What are they up to these days?	¿Qué han estado haciendo ahora?	
Is the car used or is it new?	¿El auto es usado o es nuevo?	
What is your position on the issue?	¿Cuál es su posición sobre el asunto?	
Is she cleaning a plate?	¿Ella está limpiando un plato?	
What happens after you die?	¿Qué pasa después de que mueres?	
He is still young and healthy.	Él todavía es joven y saludable.	
The soccer field is huge.	El campo de fútbol es enorme.	
We were here last Saturday.	Estuvimos aquí el sábado pasado.	
He was critical of my opinion.	Él fue crítico con mi opinión.	
Hold on to your belongings.	Aférrese a sus pertenencias.	
Where were you previously living?	¿En dónde vivías antes?	
What color is your bag?	¿De qué color es tu mochila?	
"It's blue."	Es azul.	
"She isn't having breakfast."	Ella no va a desayunar.	
Radical changes were made.	Se hicieron cambios radicales.	
Would you take a message please?	¿Podrías tomar un mensaje?	
She is a foreign diplomat.	Ella es una diplomática extranjera.	
I propose a new strategy.	Yo propongo una nueva estrategia.	
Do you have any vacancies?	¿Tiene alguna vacante?	
My house is close to the bank.	Mi casa está cerca del banco.	
"I'm looking for the post office."	Estoy buscando la oficina postal.	
Murder is the worst crime.	El asesinato es el peor crimen.	
This is an average day for me.	Este es un día promedio para mí.	
Do you want to go to the movies?	¿Quieres ir al cine?	
Are you watching something funny?	¿Estás viendo algo gracioso?	
What were you up to last night?	¿Qué estabas haciendo anoche?	
Sometimes bad things happen.	A veces suceden cosas malas.	
Please take me to this address.	Por favor llévame a esta dirección.	
It costs too much money.	Cuesta mucho dinero.	
What is the weather like in March?	¿Cómo es el clima en marzo?	
Do you hear her singing?	¿La escuchas cantando?	
I want a detailed explanation.	Quiero una explicación detallada.	
That is an extraordinary achievement.	Ese es un logro extraordinario.	
My head hurts a little.	Mi cabeza me duele un poco.	
Please speak more slowly.	Por favor habla más lento.	
My hands are too cold.	Mis manos están muy frías.	
How much money do you make?	¿Cuánto dinero ganas?	
We downloaded an app.	Nosotros bajamos una aplicación.	
"What's your favorite film?"	¿Cuál es tu película favorita?	
My favorite actor is Leonardo DiCaprio.	Mi actor favorito es Leonardo DiCaprio.	
What is the status on American immigration?	¿Cuál es el estado de la inmigración estadounidense?.	
How long have they lived in Portland?	¿Desde cuándo viven ellos en Portland?	
Are they identical twins?	¿Son gemelos idénticos?	
How do you say it in English?	¿Cómo dices eso en inglés?	
Can I have a receipt please?	¿Me puede dar un recibo por favor?	
"He's never ridden in a Tesla."	Él nunca ha viajado en un Tesla.	
She used to be a waitress.	Ella solía ser mesera.	
"What's your favorite movie?"	¿Cuál es tu película favorita?	
"Don't believe the fake news."	No crea las noticias falsas.	
It is bright outside today.	Está brillante afuera hoy.	
What did you do last night?	¿Qué hiciste anoche?	
"Where's Katie? -- She's at work."	¿Dónde está Katie? -- Está en el trabajo.	
"My sister's a farmer."	Mi hermana es granjera.	
Is your room clean yet?	¿Su habitación está limpia?	
She was writing an email.	Ella estaba escribiendo un correo electrónico.	
Can I borrow some money?	¿Me prestas un poco de dinero?	
Paris is a romantic city.	París es una ciudad romántica.	
The baby cried all night.	El bebé lloró toda la noche.	
"She's lying on the floor."	Está acostada en el suelo.	
Where can I buy tickets?	¿En dónde puedo comprar los boletos?	
Is everything that you said accurate?	¿Es todo lo que usted dijo preciso?	
In my case, I work from home.	En mi caso, yo trabajo desde mi hogar.	
"I'm going to go have dinner."	Voy a cenar.	
What is the value of a good education?	¿Cuál es el valor de una buena educación?.	
"Where's the mail box?"	¿Dónde está el buzón?	
Try to be on time next time.	Intente llegar a tiempo la próxima vez.	
What are you going to do tonight?	¿Qué vas a hacer esta noche?	
Why is she laughing at me?	¿Por qué se está riendo de mí?	
I started running every day.	Empecé a correr todos los días.	
You speak French very well.	Hablas francés muy bien.	
Would you like a glass of water?	¿Te gustaría un vaso de agua?	
Anyone can be a good student.	Cualquiera puede ser un buen estudiante.	
Fifteen divided by three is five.	Quince dividido por tres es cinco.	
She resembles her mother.	Ella se parece a su madre.	
Do you watch TV often?	¿Usted ve la televisión a menudo?.	
"It's going to be hot today."	Va a hacer calor hoy.	
Bernie worked for the government.	Bernie trabajó para el gobierno.	
Would you like to go for a walk?	¿Quieres ir a caminar?	
Can you show me how to do it?	¿Puede mostrarme cómo hacerlo?	
Can we have a menu please.	Podría darnos el menú por favor.	
Can you call me back later?	¿Puedes llamarme más tarde?	
Have you started your work yet?	¿Ya empezaste tu trabajo?	
I always take the bus to work.	Siempre me voy en autobús al trabajo.	
She was holding a purse.	Ella sostenía un bolso.	
How do you spell the word?	¿Cómo deletreas la palabra?	
What day are they coming over?	¿Cuándo van a venir?	
We have a lot of people to meet.	Tenemos muchas personas que conocer.	
What is your shoe size?	¿Cuál es su talla de zapato?	
She dressed up for the event.	Ella se vistió para el evento.	
That car over there is mine.	Ese coche que está allá es mío.	
Is that a bird or a plane?	¿Es eso un pájaro o un avión?.	
"I'm sleepy this afternoon."	Tengo sueño esta tarde.	
He needs some new clothes.	Necesita ropa nueva.	
I want to send this package.	Quiero enviar este paquete.	
Did you witness the robbery?	¿Usted fue testigo del robo?	
Did you send me flowers?	¿Me enviaste flores?	
The hunter killed the deer.	El cazador mató al ciervo.	
Is she friends with you right now?	¿Es tu amiga en este momento?	
"Yes, she's staying with me."	Sí, se está quedando conmigo.	
I have to wash my clothes.	Tengo que lavar mi ropa.	
Is there a store near here?	¿Hay alguna tienda por aquí?	
"I'd like a map of the city."	Me gustaría un mapa de la ciudad.	
Diamonds are very expensive.	Los diamantes son muy caros.	
My mother works at a school.	Mi mamá trabaja en una escuela.	
Do you have the character to succeed?	¿Tienes el carácter para tener éxito?.	
"She doesn't drink tea."	Ella no toma té.	
Is your toothbrush electronic?	¿Es su cepillo de dientes electrónico?	
"I don't understand what you're saying."	No entiendo lo que estás diciendo.	
Close the door when you leave.	Cierre la puerta cuando se vaya.	
What is the most likely explanation?	¿Cuál es la explicación más probable?	
"I'm getting ready to go out."	Me estoy preparando para salir.	
"I'd like to go for a walk."	Me gustaría ir a caminar.	
Is there a nightclub in town?	¿Hay algún club nocturno en el pueblo?	
How long have you been sick?	¿Cuánto tiempo ha estado enfermo?	
"I'd like to go to the store."	Me gustaría ir a la tienda.	
"I'd like to go shopping."	Quisiera ir de compras.	
Are you still upset with me?	¿Todavía está enojado conmigo?	
"I'd like a single room."	Quiero una habitación individual.	
She fell off the wall.	Ella se cayó de la pared.	
These books are ours.	Estos libros son nuestros.	
Can you give me an example?	¿Puedes darme un ejemplo?.	
Is it safe where you live?	¿Es seguro donde usted vive?	
Making mistakes is normal.	Cometer errores es normal.	
She is a strict teacher.	Ella es una maestra estricta.	
Does she dislike him?	¿A ella le desagrada?	
What does this word mean?	¿Qué quiere decir esta palabra?	
We have three (3) parrots.	Tenemos tres (3) pericos.	
Where do you get your news?	¿De dónde sacas tus noticias?	
Your car is on my property.	Su auto está en mi propiedad.	
A round trip ticket.	Un boleto redondo.	
Do you have anything cheaper?	¿Tienes algo más barato?	
Are you still angry at me?	¿Todavía está enojado conmigo?	
"You're smarter than him."	Eres más listo que él.	
"I haven't finished eating."	No he terminado de comer.	
Who was the director of that film?	¿Quién fue el director de esa película?	
I need to go to school today.	Necesito ir a la escuela hoy.	
Do you have faith in yourself?	¿Tiene fe en usted mismo?.	
"What's your favorite food?"	¿Cuál es tu comida favorita?	
"I'll tell him you called."	Le diré que llamaste.	
She is an attractive woman.	Ella es una mujer atractiva.	
My car is superior to his.	Mi auto es superior al suyo.	
"I'm coming to pick you up."	Voy a recogerte.	
They read a lot of books.	Ellos leen muchos libros.	
My throat is sore.	Me duele la garganta.	
I use the computer every day.	Uso la computadora todos los días.	
Did you register for the event?	¿Se registró para el evento?	
At what time did it happen?	¿A qué hora sucedió?	
Are you worried about the economy?	¿Está preocupado por la economía?	
I thought the movie was amazing.	Pensé que la película era increíble.	
I apologize for the inconvenience.	Pido disculpas por las molestias.	
Can you give me an example?	¿Puedes darme un ejemplo?	
I have pain in my arm.	Tengo un dolor en el brazo.	
Are you about to leave?	¿Ya te vas a ir?	
Yes, I am about to leave.	Sí, ya casi me voy.	
Are you about to leave?	¿Ya casi te vas?	
Yes, see you next week.	Sí, nos vemos la próxima semana.	
"What's your name?"	¿Cómo te llamas?	
"My name's Jack."	Me llamo Jack.	
"What's your name?"	¿Cómo te llamas?	
"My name's John."	Me llamo John.	
Is it snowing?	¿Está nevando?	
Yes, wear a coat.	Sí, abrígate.	
"What's her name?"	¿Cómo se llama?	
Her name is Jacquie.	Su nombre es Jacquie.	
"How's Ben?"	¿Cómo está Ben?	
"He's not doing so great."	No está muy bien.	
Would you like something to eat?	¿Quieres algo de comer?	
We are investigating the evidence.	Estamos investigando la evidencia.	
What is the population of Tokyo?	¿Cuál es la población de Tokio?	
Do you need anything else?	¿Necesitas algo más?	
I like reggae music.	Me gusta el reggae.	
Kendrick has been in New York since April.	Kendrick ha estado en Nueva York desde abril.	
She was working on a project.	Ella estaba trabajando en un proyecto.	
"I'd like to eat here."	Me gustaría comer aquí.	
The cost of failure is high.	El costo de fallar es alto.	
Can we sit over there?	¿Podemos sentarnos allá?	
How do you pronounce that?	¿Cómo se pronuncia eso?	
Please speak slower.	Por favor habla más lento.	
Which school does he go to?	¿A qué escuela va él?	
What color is your car?	¿De qué color es tu coche?	
"It's red."	Es rojo.	
Stealing is against the law.	Robar va en contra de la ley.	
What do you suggest I do?	¿Qué sugiere que haga?	
"I'd like to buy something."	Me gustaría comprar algo.	
When was your last argument?	¿Cuándo fue su último argumento?	
My luggage is missing.	Mi equipaje está perdido.	
I owe you a favor.	Te debo un favor.	
I sometimes watch videos.	A veces veo videos.	
"You've done the laundry."	Has lavado la ropa.	
Have you ever been to California?	¿Alguna vez has estado en California?	
No, not yet.	No, todavía no.	
How long have you been here?	¿Cuánto tiempo estuviste ahí?	
Does this road go there?	¿Este camino nos lleva allá?	
"I'll pay for the tickets."	Yo pago los boletos.	
This car is perfect for me.	Este auto es perfecto para mi.	
I have some excellent news.	Tengo unas excelentes noticias.	
She is an independent woman.	Ella es una mujer independiente.	
John is an eager student.	John es un estudiante entusiasta.	
I need additional feedback.	Necesito comentarios adicionales.	
They live in a small house.	Ellos viven en una casa pequeña.	
Are you an artistic person?	¿Usted es una persona artística?	
"She's at the gym now."	Ella está en el gimnasio.	
That restaurant is not expensive.	Ese restaurante no es caro.	
Is your password secure?	¿Tu contraseña es segura?	
I want to ask you a question.	Quiero hacerte una pregunta	
It is freezing over here.	Está helado aquí.	
Wendy planned her vacation to Europe.	Wendy planeó sus vacaciones a Europa.	
The United States has a diverse population.	Estados Unidos tiene una población diversa.	
What time are they arriving?	¿A qué hora van a llegar?	
I have a lot on my mind.	Tengo mucho en mi mente.	
Is your grandmother at home?	¿Tu abuela está en su casa?	
Do you have exact change?	¿Tiene el cambio exacto?	
What are you two talking about?	¿De qué estás hablando?	
I leaned on the wall.	Me apoyé en la pared.	
My backpack is missing.	Mi mochila está desaparecida.	
"David doesn't own a motorcycle."	David no tiene una motocicleta.	
How much money do you have?	¿Cuánto dinero tienes?	
Do you sell batteries?	¿Vendes baterias?	
"I'd like to use the internet"	Me gustaría usar el internet.	
What is the meaning of this word?	¿Qué significa esta palabra?	
The trash can is empty.	El basurero está vacío.	
"He's sick and in bed."	Él está enfermo y en cama.	
"I can't hear you clearly."	No te escucho claramente.	
Is this the moral thing to do?	¿Es esto lo moral por hacer?	
"I'm going there next year."	Voy a ir ahí el próximo año.	
Is the store far from here?	¿Está la tienda lejos de aquí?	
When do you get off work?	¿Cuándo sales del trabajo?	
"I've never seen that before."	Nunca había visto eso.	
It will arrive shortly.	Llegará en poco tiempo.	
"It doesn't usually rain."	Normalmente no llueve.	
You have a very nice car.	Tienes un coche muy bonito.	
When does the bus leave?	¿A qué hora se va el autobús?	
"Who's that man over there?"	¿Quién es ese hombre que está ahí?	
You like scary films.	Te gustan las películas de terror.	
What is your writing style?	¿Cuál es tu estilo de escritura?.	
Did you take your medicine?	¿Te tomáste tu medicina?	
"He's drinking a beer."	Él está bebiendo una cerveza.	
Would you like something to drink?	¿Te gustaría algo de tomar?	
"The sun isn't out yet."	El sol no ha salido todavía.	
What is your response to the question?	¿Cuál es su respuesta a la pregunta?.	
"He's wearing a shirt."	Él está usando una camisa.	
What is your telephone number?	¿Cuál es su número de teléfono?	
He always likes to eat out.	A él siempre le gusta comer fuera.	
"She's reading a magazine."	Ella está leyendo una revista.	
This is an effective strategy.	Esta es una estrategia efectiva.	
What is Jeff cooking?	¿Qué está cocinando Jeff?	
She is a talented model.	Ella es una modelo talentosa.	
Do you know how to cook?	¿Sabes cocinar?	
How much does this cost?	¿Cuánto cuesta?	
Can you translate this for me?	¿Puedes traducir esto por mi?	
The officer arrested the criminal.	El oficial arrestó al criminal.	
The best place in the world is here.	El mejor lugar del mundo está aquí.	
"She wasn't going to the bank."	Ella no iba al banco.	
Where do his children live?	¿Dónde viven sus hijos?	
Can you please say that again?	¿Puedes repetir eso por favor?	
I am excited to be here.	Estoy emocionado de estar aquí.	
Did she see it anywhere?	¿Ella lo ha visto en algún lugar?	
How many children do you have?	¿Cuántos hijos tienes?	
Did you come with your family?	¿Vienes con tu familia?	
Where can I find a hospital?	¿En dónde puedo encontrar un hospital?	
He is an ordinary boy.	Él es un niño ordinario.	
We need water to survive.	Necesitamos agua para sobrevivir	
Do you like to watch TV?	¿Te gusta ver la televisión?	
I have to go to the post office.	Tengo que ir a la oficina postal.	
Is there a restaurant in the hotel?	¿Hay restaurante en el hotel?	
My grandmother is retired.	Mi abuela está jubilada.	
What is your favorite movie?	¿Cuál es su película favorita?	
Does he drive a train?	¿Él conduce un tren?	
Is there any mail for me?	¿Hay algún correo para mi?	
"I'll call you on Friday."	Te llamo el viernes.	
She eats too much.	Ella come mucho.	
These bags are heavy.	Estas bolsas son pesadas.	
Do you play any sports?	¿Juegas algún deporte?	
What is your ideal job?	¿Cual es tu trabajo ideal?	
He knows three (3) languages.	Él sabe tres (3) idiomas.	
Chris has lived in Mexico since May.	Chris ha vivido en México desde mayo.	
Do you know how to cook?	¿Sabe cómo cocinar?	
Failure is not an option.	El fracaso no es una opción.	
"It's going to snow today."	Va a nevar hoy.	
You are a lazy worker.	Eres un trabajador flojo.	
Can you take a picture for me?	¿Puedes tomar una foto para mí?.	
"Don't say anything offensive."	No diga nada ofensivo.	
He is an experienced doctor.	Él es un doctor experimentado.	
What does she mean by that?	¿Qué quiere decir ella con eso?	
I cannot access the file.	No puedo acceder al archivo.	
I study history at the university.	Yo estudio historia en la universidad.	
It is very hot in the summer.	Hace mucho calor en el verano.	
How would you approach the problem?	¿Cómo abordaría usted el problema?	
I want to give you a gift.	Quiero darte un regalo.	
Would you like to watch TV?	¿Quieres ver televisión?	