The Olympians competed for the gold medal.	Los atletas olímpicos compitieron por la medalla de oro.	
What is your plan to pass the class?	¿Cuál es tu plan para aprobar la clase?	
The stock market made me rich.	El mercado de valores me hizo rico.	
Taylor is a famous actress and singer.	Taylor es una famosa actriz y cantante.	
Will you pass me the salt please?	¿Me podrías pasar la sal por favor?	
She has purple mittens.	Ella tiene mitones púrpura.	
The cheetah is a fast animal.	El guepardo es un animal rápido.	
The log floated on the river.	El tronco flotó en el río.	
Does your apartment have WiFi?	¿Tienes WiFi en tu departamento?	
The children played in the school playground.	Los niños jugaron en el patio de la escuela.	
What did you learn in school today?	¿Qué aprendió en la escuela hoy?	
Why are you acting so defensive?	¿Por qué estás actuando tan a la defensiva?	
How did you solve the puzzle?	¿Cómo resolvió el rompecabezas?	
She felt tired the following day.	Ella se sintió cansada al día siguiente.	
I have a very big office at work.	Yo tengo una oficina grande en el trabajo.	
My professor is mean to her students.	Mi profesora es mala con sus alumnos.	
"Have you seen Ashley? -- I haven't seen her."	¿Has visto a Ashley? -- No la he visto.	
Where can I charge my tablet?	¿Dónde puedo cargar mi tablet?	
Am I making you feel uncomfortable?	¿Lo estoy haciendo sentir incómodo?	
Chess is a very fun game.	El ajedrez es un juego muy divertido.	
Please be gentle with my baby.	Por favor sea amable con mi bebé.	
They digged for treasure.	Cavaron en busca de tesoros.	
She always has fun at parties.	Ella siempre se divierte en las fiestas.	
The press covered the war in detail.	La prensa cubrió la guerra en detalle.	
Does your knee still hurt?	¿Todavía le duele la rodilla?	
Are the effects of caffeine permanent?	¿Los efectos de la cafeína son permanentes?	
She suffers from her illness.	Ella sufre por su enfermedad.	
I think the agreement is fair to everyone.	Creo que el acuerdo es justo para todos.	
The story of Romeo and Juliet is known all over the world.	La historia de Romeo y Julieta es conocida en todo el mundo.	
I skipped breakfast this morning.	Me salté el desayuno esta mañana.	
My father is a taxi driver.	Mi padre es un taxista.	
I still have a lot of things to buy.	Todavía tengo muchas cosas que comprar.	
What did James say at the meeting?	¿Qué dijo James en la reunión?	
I traveled to the airport by train.	Viajé hacia el aeropuerto en tren.	
The colors in the painting are prominent.	Los colores en la pintura son prominentes.	
I often watch videos in the morning.	Frecuentemente veo videos en la mañana.	
These red flowers are lovely.	Estas flores rojas son encantadoras.	
The apprentice observed his master.	El aprendiz observó a su maestro.	
He eats a lot of vegetables.	Él come muchas verduras.	
Did you watch the presidential debate?	¿Vio el debate presidencial?.	
How much is a plane ticket to Los Angeles?	¿Cuánto cuesta un boleto de avión a Los Ángeles?	
How many languages do you speak?	¿Cuántos idiomas hablas?	
"I'll have a glass of water please."	Quiero un vaso de agua por favor.	
"It's not supposed to rain today."	Se supone que no llovería hoy.	
They played volleyball this morning.	Ellos jugaron voleibol esta mañana.	
He was a terrible father and husband.	Él era un terrible padre y esposo.	
My Amazon package was delivered today.	Mi paquete de Amazon fue entregado hoy.	
"He doesn't perform well at work."	Él no trabaja bien.	
The forest is surrounded with trees.	El bosque está rodeado de árboles.	
How long has she been in Canada?	¿Cuánto tiempo lleva ella en Canadá?	
"She's been in Canada since Wednesday."	Ha estado en Canadá desde el miércoles.	
How long has she been in Canada?	¿Desde hace cuánto está ella en Canadá?	
Can Jose make it to the meeting? -- No, he cannot.	¿José puede venir a la junta? -- No, no puede.	
Charles is the most senior person at the company.	Charles es la persona de mayor rango en la compañía.	
Sorry, I think I have the wrong number.	Perdón, creo que tengo el número equivocado.	
She likes comedy films.	A ella le gustan las películas de comedia.	
I am glad that I got the job.	Estoy contento de haber conseguido el trabajo.	
Mike eats breakfast every day.	Mike desayuna todos los días.	
The party ended around sunrise.	La fiesta terminó al amanecer.	
She has a pink toothbrush.	Ella tiene un cepillo de dientes rosado.	
"The text message wasn't delivered."	El mensaje de texto no fue entregado.	
Honey attracts flies.	La miel atrae a las moscas.	
Cesar arrived twenty (20) minutes ago.	César llegó hace veinte (20) minutos.	
I got lost on the way to my house.	Yo me perdí en el camino a mi casa.	
My apartment has a view of the city.	Mi apartamento tiene una vista de la ciudad.	
Does her son have a motorcycle?	¿Su hijo tiene una motocicleta?	
His handshake is very firm.	Su apretón de manos es muy firme.	
Do you have enough training for the job?	¿Tienes el entrenamiento suficiente para el trabajo?	
Has Jinyang bought a new phone yet?	¿Jinyang ya compró un nuevo teléfono?	
How many people live in your country?	¿Cuántas personas viven en su país?	
Are your glasses made of plastic?	¿Sus lentes están hechos de plástico?.	
Do you see a cafe nearby?	¿Usted ve un café cerca?	
We live in a residential neighborhood.	Vivimos en un barrio residencial.	
She always dresses nicely.	Ella siempre se viste bien.	
Is the library close to where you live?	¿Está la biblioteca cerca de donde vives?.	
Anthony lifts weights.	Anthony levanta pesas.	
"He's eating ice cream."	Él está comiendo helado.	
It often snows in the winter.	Nieva seguido en invierno.	
"She hasn't got much coffee."	Ella no tiene mucho café.	
Justin and Britney have been together for five (5) months.	Justin y Britney han estado juntos desde hace cinco (5) meses.	
Did you complete the assignment on time?	¿Completó la tarea a tiempo?	
Sorry, we only accept cash.	Lo siento, solo aceptamos efectivo.	
Did you achieve everything you wanted?	¿Usted logró todo lo que quería?	
He discovered the cure for cancer.	Él descubrió la cura para el cáncer.	
I always make my bed in the morning.	Siempre hago mi cama por la mañana.	
"The weather's sunny today."	El día está soleado hoy.	
"I'd like to send a fax."	Me gustaría enviar un fax.	
I like to volunteer in my free time.	Me gusta ser voluntario en mi tiempo libre.	
How did you access your email?	¿Cómo entraste a tu correo electrónico?	
Today is a pleasant Summer day.	Hoy es un agradable día de verano.	
There is a secret room in the museum.	Hay una habitación secreta en el museo.	
"I don't play the guitar very well."	No toco muy bien la guitarra.	
Try to walk in a straight line.	Intenta caminar en línea recta.	
Is there air conditioning in the room?	¿Hay aire acondicionado en el cuarto?	
"Let's meet in front of the hotel."	Hay que vernos frente al hotel.	
Pardon me, does he speak Chinese?	Disculpa, ¿Él habla chino?	
What is the context for your remark?	¿Cuál es el contexto de tu comentario?.	
What is the economic situation in your country?	¿Cuál es la situación económica de su país?	
Do you know where my glasses are?	¿Sabes dónde están mis lentes?	
Did you eat breakfast yesterday?	¿Desayunaste ayer?	
The criminals escaped from prison.	Los criminales escaparon de la prisión.	
What do you think of classical music?	¿Qué piensa de la música clásica?	
When will they arrive at the airport?	¿Cuándo llegarán ellos al aeropuerto?	
Can you recommend a good restaurant?	¿Puedes recomendarme un buen restaurante?	
Your shirt is nice. Is it new?	Tu camisa está bonita. ¿Es nueva?	
Yes, it is.	Sí, es nueva.	
When do you usually wake up?	¿A qué hora despiertas normalmente?	
What is your concern about the product?	¿Cuál es su preocupación sobre el producto?.	
Tom demonstrated how the machine works.	Tom demostró cómo funciona la máquina.	
What do your parents do for work?	¿En qué trabajan tus papás?	
Light emerged from the darkness.	La luz emergió de la oscuridad.	
He doubled his wager.	Él duplicó su apuesta.	
What do you mean when you say that?	¿Qué quiere decir cuando dice eso?	
There are no classes on Saturday.	No hay clases los sábados.	
She always works diligently.	Ella siempre trabaja diligentemente.	
The cowboy shot his gun.	El vaquero disparó su arma.	
The answer to your question is complicated.	La respuesta a tu pregunta es complicada.	
Last month, Valerie drove from San Diego to La Paz.	El mes pasado, Valerie manejó de San Diego a La Paz.	
What is the distance between Earth and the moon?	¿Cuál es la distancia entre la Tierra y la Luna?.	
They prayed for world peace.	Rezaron por la paz mundial.	
I work as a teacher at that school.	Trabajo como maestro en esa escuela.	
The accident happened at the intersection.	El accidente sucedió en la intersección.	
I want to contact our embassy.	Quiero contactar a nuestra embajada.	
"Sorry, I didn't hear clearly."	Perdón, no escuché claramente.	
She ate the whole pizza.	Ella se comió toda la pizza.	
The highest mountain on earth is Mount Everest.	La montaña más alta de la tierra es el Monte Everest.	
What do you see outside the window?	¿Qué ve afuera de la ventana?.	
I respect my parents very much.	Yo respeto mucho a mis padres.	
What will the weather be like tomorrow?	¿Cómo estará el clima mañana?	
Can I see your passport please?	¿Puedo ver su pasaporte por favor?	
"I'd like to send this to America."	Quisiera enviar esto a América.	
The force of gravity is higher on Jupiter.	La fuerza de la gravedad es mayor en Júpiter.	
We walked to the ocean yesterday.	Ayer caminamos hacia el océano.	
Do you think the plan is realistic?	¿Usted cree que el plan es realista?	
He is the coolest guy in the world.	Él es el chico más genial del mundo.	
Is your name on the guest list?	¿Su nombre está en la lista de invitados?.	
The village is in a remote location.	El pueblo está en una ubicación remota.	
Is caffeine considered a drug?	¿La cafeína es considerada una droga?.	
The museum is free every Friday.	El museo es gratis todos los viernes.	
Do you want to see the movie with me?	¿Quiere ver la película conmigo?	
We live in a tiny apartment.	Vivimos en un pequeño apartamento.	
Is this a dream or is this reality?	¿Es esto un sueño o es esto realidad?.	
"He's not running around the track."	Él no está corriendo por la pista.	
"I've owned it since February."	Lo obtuve desde febrero.	
I think what he did was reasonable.	Creo que lo que hizo fue razonable.	
This alley is very narrow.	Este callejón es muy estrecho.	
Refrigerators preserve food.	Los refrigeradores conservan los alimentos.	
"It's been snowing all day."	Ha estado nevando todo el día.	
You found my key last night.	Encontraste mi llave anoche.	
I have no chronic illnesses.	No tengo enfermedades crónicas.	
"I'm sorry, we're sold out."	Lo sentimos, está agotado.	
Be prepared for the powerful storm.	Prepárese para la poderosa tormenta.	
Do you need to commute to work?	¿Necesita viajar al trabajo?	
Are you able to attend the wedding?	¿Está disponible para asistir a la boda?	
"I'm studying English right now."	Estoy estudiando inglés en este momento.	
These sheets are so soft.	Estas sábanas son muy suaves.	
"My cell phone doesn't work."	Mi celular no funciona.	
My shoelaces are loose.	Mis cordones están sueltos.	
"It'll be cold this evening."	Va a hacer frío esta tarde.	
Please proceed through the entrance.	Por favor proceda a través de la entrada.	
Do you know how much it costs?	¿Sabes cuánto cuesta?	
"She wasn't wearing socks."	Ella no traía puestos calcetines.	
When will you launch the new website?	¿Cuándo lanzará el nuevo sitio web?	
My car is painted yellow.	Mi auto está pintado de amarillo.	
The politician denied the allegations.	El político negó las acusaciones.	
The turtle is a slow animal.	La tortuga es un animal lento.	
What makes this university so special?	¿Qué hace que esta universidad sea tan especial?	
She is an advanced pianist.	Ella es una pianista avanzada.	
Where do his grandparents stay?	¿Dónde se quedan sus abuelos?	
The soup tastes delicious.	La sopa sabe deliciosa.	
We used to live in the United States.	Nosotros solíamos vivir en Estados Unidos.	
She is a famous movie star.	Ella es una famosa estrella de cine.	
I would like to do something meaningful.	Me gustaría hacer algo significativo.	
Would you like coffee or tea?	¿Quieres café o té?	
Can you speak louder please?	¿Puedes hablar más fuerte por favor?	
She became the first female president.	Ella se convirtió en la primera mujer presidente.	
Does she want to pass the test?	¿Ella quiere pasar el examen?	
The children are coming home from school.	Los niños están viniendo a casa de la escuela.	
"He's in the workshop building something."	Él está en el taller construyendo algo.	
I think you have too many clothes.	Creo que tienes mucha ropa.	
A single vote decided the election.	Un solo voto decidió la elección.	
When did he sell his phone?	¿Él cuándo vendió su teléfono?	
I can count to ten in French.	Puedo contar hasta diez en francés.	
I dreamed about a better future.	Soñé con un futuro mejor.	
Bill Gates built a nice computer system.	Bill Gates creó un buen sistema para computadoras.	
The public is smarter than you think.	El público es más inteligente de lo que usted piensa.	
She turned sixteen yesterday.	Ella cumplió dieciséis ayer.	
Do you enjoy extreme sports?	¿Usted disfruta de los deportes extremos?	
"I want to know because I'm curious."	Quiero saber porque soy curioso.	
Do you accept credit cards?	¿Aceptas tarjetas de crédito?	
Who do you rely on for support?	¿En quién confía usted para tener apoyo?	
My favorite number is seventeen.	Mi número favorito es el diecisiete.	
The president is an important part of the government.	El presidente es una parte importante del gobierno.	
I live not too far from work.	Yo no vivo muy lejos del trabajo.	
"I've worked there for five years."	He trabajado ahí por cinco años.	
He is the son of a very important man.	Él es el hijo de un hombre muy importante.	
We often read a book together.	Nosotros seguido leemos un libro juntos.	
The noise was loud and constant.	El ruido era fuerte y constante.	
My goal for the year is to be happy.	Mi objetivo para el año es ser feliz.	
Twelve times three is thirty six.	Doce veces tres es treinta y seis.	
Are you single? -- No, I am married.	¿Eres soltero? -- No, soy casado.	
"He doesn't have her contact information."	Él no tiene su información de contacto.	
Does he think that I am stupid?	¿Él piensa que yo soy estúpido?	
I will e-mail you tomorrow.	Le enviaré un correo electrónico mañana.	
I met that girl in high school.	Conocí a esa chica en la escuela secundaria.	
Can I have a glass of water please?	¿Puede traerme un vaso con agua por favor?	
How long has she been learning Italian?	¿Cuánto tiempo lleva aprendiendo italiano?	
She was very friendly to the guests.	Ella fue muy amistosa con los invitados.	
What are you doing later in the evening?	¿Qué va a hacer más tarde en la noche?	
"Do you have a motorcycle? -- No, I don't."	¿Tienes una motocicleta? -- No, no tengo.	
He voted for the first time this year.	Él votó por primera vez este año.	
Are you training for the marathon in May?	¿Está entrenando para el maratón en mayo?	
I hung the painting on the wall.	Colgué la pintura en la pared.	
What do they want for brunch?	¿Qué quieren ellos para almorzar?	
"Please be quiet. I'm studying."	Por favor guarda silencio. Estoy estudiando.	
I wonder what she does for work.	Me pregunto en qué trabaja ella.	
Why was the train late to the station?	¿Por qué llegó tarde el tren a la estación?	
"I'm thirsty but not hungry."	Tengo sed, pero no hambre.	
Donald caught the ball with two hands.	Donald atrapó el balón con dos manos.	
"I don't like to wash the motorcycle."	No me gusta lavar la motocicleta.	
"I'd like to make a phone call."	Quisiera hacer una llamada.	
Prices are low where I live.	Los precios son bajos donde vivo.	
Can I get your advice on the issue?	¿Puedo obtener tu consejo sobre el asunto?.	
"The website's design is amazing."	El diseño del sitio web es increíble.	
Where can I get tourist information?	¿Dónde puedo obtener información turística?	
Where did you put your keys?	¿Dónde puso sus llaves?	
Is your mother a hard worker?	¿Tu mamá es muy trabajadora?	
Are you aware of the latest news?	¿Está enterado de las últimas noticias?	
The sofa has a modern look.	El sofá tiene un aspecto moderno.	
"We don't usually watch TV."	Normalmente no vemos la televisión.	
We all have the right to a happy life.	Todos tenemos el derecho a una vida feliz.	
He is confident in his abilities.	Él es seguro de sus habilidades.	
The water does not look pure.	El agua no se ve pura.	
His parents live in New York.	Sus papás viven en Nueva York.	
How long have you known Mark?	¿Desde hace cuánto que conoces a Mark?	
I have an exclusive offer for you.	Tengo una oferta exclusiva para usted.	
I understand what the teacher is saying.	Entiendo lo que el maestro está diciendo.	
Soccer is a technical sport.	El fútbol es un deporte técnico.	
The restaurant is closed on Monday.	El restaurante está cerrado los lunes.	
Are the orders together or separate?	¿Están las órdenes juntas o separadas?	
Are any stores open today?	¿Hay alguna tienda abierta hoy?	
Have you seen the new movie yet?	¿Ya ha visto la nueva película?.	
Would you ask him to come here?	¿Le puedes decir que venga aquí?	
Polar bears are white.	Los osos polares son blancos.	
Why are you wearing a jacket?	¿Por qué traes puesta una chamarra?	
It is too cold here.	Hace mucho frío aquí.	
He is very happy with his job.	Él está muy feliz con su trabajo.	
I would like to thank you for the opportunity.	Me gustaría agradecerle por la oportunidad.	
Can you help me light the match?	¿Puede ayudarme a encender el fósforo?	
"Does she know what I'm saying?"	¿Ella sabe lo que estoy diciendo?	
"It's supposed to rain tomorrow."	Se supone que lloverá mañana.	
This sofa is very comfortable.	Este sofá es muy cómodo.	
I need this to get there by tomorrow.	Necesito que esto llegue ahí para mañana.	
"You stepped on me. -- I'm sorry."	Me pisaste. -- Lo siento.	
Is it supposed to rain tomorrow?	¿Se supone que va a llover mañana?	
I have a sister, but no brothers.	Tengo una hermana, pero no hermanos.	
Did you go to the weekly meeting?	¿Usted fue a la reunión semanal?	
Do you notice anything unusual?	¿Nota algo inusual?	
The respect between us is mutual.	El respeto entre nosotros es mutuo.	
She is afraid to lose everything.	Ella está asustada de perder todo.	
Are you watching TV right now?	¿Estás viendo la televisión?	
"Yes, don't turn it off."	Sí, no la apagues.	
San Francisco has some steep hills.	San Francisco tiene algunas colinas empinadas.	
My father has his own business.	Mi padre tiene su propio negocio.	
Are you waiting for your mother?	¿Estás esperando a tu mamá?	
"No, I'm waiting for my father."	No, estoy esperando a mi papá.	
"What's your favorite color?"	¿Cuál es tu color favorito?	
My favorite color is red.	Mi color favorito es el rojo.	
"Nathan isn't here. He went to work."	Nathan no esta aquí. Se fue al trabajo.	
"I've been here for two days."	He estado aquí por dos días.	
How long are you going to stay?	¿Cuánto tiempo te vas a quedar?	
"You've always played football."	Tú siempre has jugado fútbol.	
My grandfather never retired.	Mi abuelo nunca se retiró.	
Can you throw that away for me?	¿Puedes tirar eso por mi?	
The school year ends in June.	El año escolar termina en junio.	
What time does the store open?	¿A qué hora abre la tienda?	
I am certain that she is right.	Estoy seguro de que ella tiene razón.	
"It's sunny outside today."	Está soleado afuera.	
Have you applied to college yet?	¿Ya has aplicado para la universidad?	
Newton discovered the theory of gravity.	Newton descubrió la teoría de la gravedad.	
"She's eating an orange."	Ella está comiendo una naranja.	
Tom lost his sense of smell.	Tom perdió su sentido del olfato.	
My friend has three dogs.	Mi amigo tiene tres perros.	
Are you a teacher? -- Yes, I am.	¿Eres maestro? -- Sí, soy maestro.	
Will you put this in the car for me?	¿Podrías poner esto en el coche por mi?	
There are a lot of things in the school.	Hay muchas cosas en la escuela.	
That university has a lot of students.	Esa universidad tiene muchos estudiantes.	
Gold is a rare element.	El oro es un elemento raro.	
Please fill out this form.	Por favor llena esta forma.	
They used to wear contacts.	Ellos solían utilizar lentes de contacto.	
What are you doing under the table?	¿Qué haces abajo de la mesa?	
The chair is missing a leg.	Le falta una pata a la silla.	
What is the conventional way to do this?	¿Cuál es la forma convencional de hacer esto?	
My teacher is so nice to me.	Mi maestra es muy amable conmigo.	
That town has three churches.	Esa ciudad tiene tres iglesias.	
How long have you lived here?	¿Cuánto tiempo viviste aquí?	
Does it rain here often?	¿Llueve seguido aquí?	
"She's sitting on the couch."	Está sentada en el sillón.	
"Where's the nearest hospital?"	¿Dónde está el hospital más cercano?	
I already took the trash out.	Yo ya saqué la basura.	
"Sorry, I don't have a pencil."	Lo siento, no tengo un lápiz.	
They like post-rock music.	A ellos les gusta la música post-rock.	
What does it mean to be American?	¿Qué significa ser americano?	
Is Keenan there? -- Yes, he just arrived.	¿Está Keenan? -- Sí, acaba de llegar.	
"I haven't had lunch yet."	Todavía no he almorzado.	
She is an excellent chef.	Ella es una excelente chef.	
Do you like scary movies?	¿Le gustan las películas de miedo?	
I will never forget this moment.	Nunca olvidaré este momento.	
What is the main attraction here?	¿Cuál es la principal atracción aquí?	
"I'd like to speak to you please."	Me gustaría hablar contigo por favor.	
I thought he said something else.	Pensé que él había dicho otra cosa.	
October is my favorite month.	Octubre es mi mes favorito.	
I need to leave now. Bye.	Ya tengo que irme. Adiós.	
I think I need to see a doctor.	Creo que necesito ver a un doctor.	
Kids usually like candy.	A los niños normalmente les gustan los dulces.	
The situation seems odd to me.	La situación a mi me parece rara.	
Do you have the number for a taxi?	¿Tienes el teléfono de algún taxi?	
Why are you being so dramatic?	¿Por qué está siendo tan dramático?	
There has been a car accident.	Hubo un accidente automovilístico.	
The villagers destroyed the forest.	Los lugareños destruyeron el bosque.	
She is the leader of the group project.	Ella es la líder del proyecto grupal.	
"Where is your brother's job?"	¿Dónde es el trabajo de tu hermano?	
He always goes to work early.	Él siempre va a trabajar muy temprano.	
"There's a restaurant near here."	Hay un restaurante cerca de aquí.	
I searched for my wallet.	Yo busqué mi billetera.	
"I'd like to make a reservation."	Me gustaría hacer una reservación.	
Butterflies have two (2) wings.	Las mariposas tienen dos (2) alas.	
Catherine works very hard.	Catherine trabaja muy duro.	
How would you assess the situation?	¿Cómo evaluaría la situación?	
What do people usually do here?	¿Generalmente qué hace la gente aquí?	
Are you listening to her right now?	¿La estás escuchando?	
Thank you for your continued support.	Gracias por su continuo apoyo.	
"It's longer than two (2) miles."	Son más de 2 millas.	
Do you like your co-workers?	¿Te agradan tus compañeros de trabajo?	
Who is the most popular celebrity?	¿Quién es la celebridad más popular?	
Language learning is fun to me.	El aprendizaje de idiomas es divertido para mí.	
"I'd like to rent a car."	Me gustaría rentar un coche.	
I often take the bus to school.	Seguido tomo el autobús para ir a la escuela.	
He was going to basketball practice.	Él iba a la práctica de basquetbol.	
"This is the first time I've been here."	Esta es la primera vez que he estado aquí.	
If you like it I can buy more.	Si te gusta, puedo comprar más.	
Is it hot today? -- Yes, it is.	¿Hace calor hoy? -- Sí, sí hace.	
I assume that you are a nurse.	Asumo que usted es una enfermera.	
Russia is a very big country.	Rusia es un país muy grande.	
The effects of the drug are unknown.	Los efectos de la droga son desconocidos.	
An important part of life is work.	Una parte importante de la vida es el trabajo.	
My father works at a bank.	Mi papá trabaja en un banco.	
Would you like to have dinner with me?	¿Te gustaría cenar conmigo?	
What time did you go to sleep?	¿A qué hora te fuiste a dormir?	
Bring me my shirt please.	Tráeme mi playera, por favor.	
How much was the train ticket?	¿Cuánto costó el boleto de tren?	
Please take off your shoes.	Por favor quítate los zapatos.	
Does he run outside often?	¿Él sale a correr seguido?	
You do different things every day.	Haces cosas diferentes todos los días.	
I do have a phone charger.	Yo sí tengo un cargador de teléfono.	
I want an exciting adventure.	Quiero una aventura emocionante.	
They raced around the track.	Corrieron alrededor de la pista.	
The cost of living is rising in San Francisco.	El costo de la vida está aumentando en San Francisco.	
Do we live on the same street?	¿Vivimos en la misma calle?	
He kissed her for the first time.	Él la besó por primera vez.	
"How're they doing now?"	¿Cómo les va ahora?	
"I'm going home in four days."	Voy a casa en cuatro días.	
When did Jeff take out the trash?	¿Cuándo sacó Jeff la basura?	
What time does the museum close?	¿A qué hora cierra el museo?	
These snakes are deadly.	Estas serpientes son mortales.	
Can you identify the man in the picture?	¿Puede identificar al hombre en la imagen?	
Their car is on the way to the airport.	Su auto está en camino hacia el aeropuerto.	
He always leaves work late.	Él siempre sale tarde del trabajo.	
Would you like to rent a movie?	¿Te gustaría rentar una película?	
Were you at the library last night?	¿Estabas en la librería anoche?	
"Where's the closest restaurant?"	¿Cuál es el restaurante más cercano?	
Excuse me, what did you say?	Perdón ¿Qué dijiste?	
Linguistics is the study of language.	La lingüística es el estudio del lenguaje.	
Are you interested in American politics?	¿Estás interesado en la política estadounidense?.	
Success is the result of hard work.	El éxito es el resultado del trabajo duro.	
Blue is my favorite color.	El azul es mi color favorito.	
Be careful around the fireplace.	Sea cuidadoso alrededor de la chimenea.	
Do you know how to get to the hotel?	¿Sabes cómo llegar al hotel?	
"Have you seen Jon? -- He's in the bathroom."	¿Has visto a Jon? -- Está en el baño.	
The teacher is the leader of the classroom.	El maestro es el líder del aula.	
Have you eaten at that restaurant?	¿Ya has comido en ese restaurante?	
Where was she on Saturday morning?	¿Dónde estaba ella el sábado por la mañana?	
Were you surprised by the good news?	¿Se sorprendió por las buenas noticias?	
"We saw Rita, but we didn't see Javier."	Vimos a Rita, pero no vimos a Javier.	
How was the weather when you went to Hawaii?	¿Cómo estaba el clima cuando fuiste a Hawaii?	
I am optimistic about the future.	Soy optimista sobre el futuro.	
I need to tie my shoes.	Necesito atarme los zapatos.	
"She often doesn't have breakfast."	Ella no desayuna frecuentemente.	
Somebody is swimming in the lake.	Alguien está nadando en el lago.	
"How're they doing now?"	¿Cómo les va ahora?	
Chess is a strategic game.	El ajedrez es un juego estratégico.	
There is a group of children at the school.	Hay un grupo de niños en la escuela.	
The technology company transformed the world.	La compañía de tecnología transformó el mundo.	
Ajay has three (3) children.	Ajay tiene tres (3) hijos.	
Do your children speak Chinese?	¿Tus hijos hablan chino?	
Einstein proved that the theory was true.	Einstein probó que la teoría era verdadera.	
The fire keeps us warm.	El fuego nos mantiene calientes.	
The whole nation wants peace.	Toda la nación quiere paz.	
"I'll take you to the bus stop."	Te llevaré a la parada de autobús.	
What do you think of these shoes?	¿Qué piensas de estos zapatos?	
He had plenty of good jobs.	Él tuvo muchos buenos trabajos.	
He likes to drink beer.	A él le gusta beber cerveza.	